ID	Precursor	Mature_peptide	Mature_score
XP_030041419.1 C-C motif chemokine 4-like [Microcaecilia unicolor]	MKLCLTALCVLLLAAFCSEVFSAPTGADIPTSCCFSYTSRKLPRGHVQDYFVTSSMCAQPAIIFITRKGREVCANPDEEWVENYVNDLELN	------------------------TGADIPTSCCFSYTSRKLPRGHVQDYFVTSSMCAQPAIIFITRKGREVCANPD--------------	0.77
XP_030041438.1 C-C motif chemokine 4-like [Microcaecilia unicolor]	MKLCLTVLCVTLLAAFCSQVLSAPAGSDPTSCCFSYASRQIPRKHVREYYYTSSRCTQPAVIFVTWRNREICANPETKWVQDHVNYLEMNSKQLKPSNI	-----------------------PAGSDPTSCCFSYASRQIPRKHVREYYYTSSRCTQPAVIFVTWRNREICANPETKWVQDHVNYLEMNSKQLKPSN-	0.85
XP_030041503.1 40S ribosomal protein S19 [Microcaecilia unicolor]	MPGVTVKDVNQQEFVRALSAFLKKSGKLKVPEWVDTVKLAKHKELAPYDENWFYTRAASTARHLYLRGGAGVGSMTKIYGGRQRNGVMPSHFSRGSKSVARRVLQALEGLKMVEKDPNGGRKLTPQGQRDLDRIAGQVAAASKKH	--------------------FLKKSGKLKVPEWVDTVKLAKHKELAPYDENWFYTRAASTARHLYLRGGAGVGSMTKIYGGRQRNGVMPSHFSRGSKSVARRVLQALEGLKMVEKDPNGGRKLTPQGQRDLDRIAGQVAAASKKH	0.77
XP_030041612.1 C-C motif chemokine 4-like [Microcaecilia unicolor]	MKLCQIACCVLLLTSFSQVLSAPVGADIPASCCFSYTSRRIPQSHVKAYFSTNSLCSQAAIIFVTRKGREVCANPEETWVQSYINGLKPK	----------------------PVGADIPASCCFSYTSRRIPQSHVKAYFSTNSLCSQAAIIFVTRKGREVCANPEETWVQSYINGLKPK	0.89
XP_030041930.1 trypsin-3-like [Microcaecilia unicolor]	MIIVAGEHSLSMFEGTEQLFRPIKMVTHPDYSSVSRNADIMLIKLNRPALYNAFVSVVPLPKQGAAMNEGRFCQVFGWGYTSTLGGKTSDTLRSVKLPIVSKWKCNGTAAYAGHITNNMICAGFSVGGKDACQGDSGGPLVCDGRLFGIVSWGNSCASPRYPGVYTAVSSFRKWIYKTIG	---------------------------------------------------------V-----GAAMNEGRFCQVFGWGYTSTLGGKTSDTLRSVKLPIVSKWKCNGTAAYAGHITNNMICAGFSVGGKDACQGDSGGPLVCDGRLFGIVSWGNSCASPRYPGVYTAVSSFRKWIYKTI-	0.8
XP_030041931.1 trypsin-3-like [Microcaecilia unicolor]	MIIVAGEHSLSMFEGTEQLFRPIKMVTHPDYSSVSRNADIMLIKLNRPALYNAFVSVVPLPKQGAAMNEGRFCQVFGWGYTSTLGGKTSDTLRSVKLPIVSKWKCNGTAAYAGHITNNMICAGFSVGGKDACQGDSGGPLVCDGRLFGIVSWGNSCASPRYPGVYTAVSSFRKWIYKTIG	---------------------------------------------------------V-----GAAMNEGRFCQVFGWGYTSTLGGKTSDTLRSVKLPIVSKWKCNGTAAYAGHITNNMICAGFSVGGKDACQGDSGGPLVCDGRLFGIVSWGNSCASPRYPGVYTAVSSFRKWIYKTI-	0.81
XP_030042278.1 C-type natriuretic peptide-like [Microcaecilia unicolor]	MRASLWVFFLLSLVLCVQSKPVQPRRHHKVPVDLLREDSRALVSVEQTPATSQQTSPEPRPLREAPADSTATESTSPSSNRGWLRFFNDFMNNQKKFRGRTKKMPSQGCFGAKLDRIGALSGFGC	---------------------------------------------------------------------------------GWLRFFNDFMNNQKKFRGRTKKMPSQGCFGAKLDRIGALSGFGC	0.82
XP_030042280.1 bone marrow proteoglycan-like [Microcaecilia unicolor]	MKVYMILLLLLLGTTSAQESGEEDLEELGDNEMDLLTEEESTAEEEEEEETTPLASDCQEECGEKKILIESSKLCNGSETCQYLIILCHQTFQQAQRTCRCHKGQLTSISNQCVNQSILSRVFAQNTRAPSFWIGLQKSSGHQRFRWVDGRCLTYQNWANGEPRRCGQQCVTMDKRSGKWCTSNCNARRPFICRI	-------------------------------------------------------------------------LCN----CQYLIILCHQTFQQAQRTCRCHKGQLTSISNQCVNQSILSRVFAQNTRAPSFWIGLQKSSGHQRFRWVDGRCLTYQNWANGEPRRCGQQCVTMDKRSGKWCTSNCNARRPFICRI	0.78
XP_030042287.1 bone marrow proteoglycan-like [Microcaecilia unicolor]	MKVYMILLLLLLGTTSAQESGEEDLEELGDNEMDLLTEEESTAEEEEEEETTPLASDCQEECGEKKILIESSKLCNGSETCQYLIILCHQTFQQAQRTCRCHKGQLTSISNQCVNQSILSRVFAQNTRAPSFWIGLQKSSGHQRFRWVDGRCLTYQNWANGEPRRCGQQCVTMDKRSGKWCTSNCNARRPFICRI	------------------------------------------------------------------ILIE-SKLCN-SETCQYLIILCHQTFQQAQRTCRCHKGQLTSISNQCVNQSILSRVFAQNTRAPSFWIGLQKSSGHQRFRWVDGRCLTYQNWANGEPRRCGQQCVTMDKRSGKWCTSNCNARRPFICRI	0.79
XP_030042296.1 pulmonary surfactant-associated protein C-like [Microcaecilia unicolor]	METGSKTDLVDTPPVYSFSPKTWSDRKRKTVIVSIVVVLLALMTVAAILIGIKLTQDHTEKIFQITHNENGKETQETTTINKKGGVATFYVNEDNTSATVVYDYTNGVIGIKGDPSTCYVTKMDKNKVPSLDSISKKYQALQASVSGSNSVQKQDAYFTAQKEPVADRSMLGTTINVLCSNNPIYWTQETSGDTKSAARRACLRIRVCNRYYCYVFLRCF	-------------------------------------------------------------------------------------------------------------------------------------------------------------------------------------------------------RACLRIRVCNRYYCYVFLRCF	0.87
XP_030042517.1 sialic acid-binding lectin-like [Microcaecilia unicolor]	MRAFQLLLSPLPCLSLLLALIFPSTSQNYDEFRKKHIDSRTNKKHNNQYCNTIMEQKINRDTGTCRKVNTFIHAPEKVVVILCRRIPNAMKTSTKKFSLTICKLQRKRGQRCTYKAKNEFRRIEIKCEDSLPVHFCGDVPPVKDKHWRERGGGWELLSVSDQIKCE	----------------------------------KHIDSRTNKKHNNQYCNTIMEQKINRDTGTCRKVNTFIHAPEKVVVILCRRIPNAMKTSTKKFSLTICKLQRKRGQRCTYKAKNEFRRIEIKCEDSLPVHFCGDVPPVKDKHWRERGGGWELLSVSDQIKC-	0.83
XP_030042792.1 osteocalcin [Microcaecilia unicolor]	MRPLTLVTLLALAVICLCHRDADNSNGAPDAHNTEAIASNPASANAFVKRNKRQYNPNSYGANAVGPDPLEPYREVCELSPDCDELADQIGFEEAYRRFYGPL	----------------------DNSNGAP-------I-SNP-S-NAFVK-NKRQYNPNSYGANAVGPDPLE----------------DQIGF---YRRFYGP-	0.57
XP_030042855.1 lectin-like [Microcaecilia unicolor]	MMRKITELMLILAVVFTAGQAADEESWCTTGWSCFFSAYYKFVSTPLSWVEAELHCQKLIPGGHLASLHSLEEQQFVLKLSKNNVIWIGASDSYKDRTFFWTDGSAWDYENWHSGEPNNFHGTREACVNSYYFSDDTWNDFICTAKFPFTCKVTGPSCLTNQIVG	------------------------------GWSCFFSAYYK--------------------------------------------IWIGASDSYKDRTFFWTDGSAWDYENWHSGEPNNFHGTREACVNSYYFSDDTWNDFICTAKFPFTCKVTGPSCLTNQIV-	0.75
XP_030042874.1 killer cell lectin-like receptor subfamily F member 1 isoform X2 [Microcaecilia unicolor]	MQSENYYTTLNFDVKKRPHPGMSQGMMEAAQRCPRWHRIALGIGGAGHLLLLGAVIALSLRGFWYHPTGCNGEGPSINTSDLHSSQCLQNQGTHRESKNITAAVSAFTGCAGDWLHHGGKCYFFSMTLKSWSDSRDDCAKRDAQLLEIQDASELVFIHNSRKAKNRAWIGLRITAPGHQWKWVTGLAVDTVRII	---------------------------------------------------------------------------------------------------------------------------------------------------------------SRKAKNRAWIGLRITAPGHQWKWVTGLAVDTVRII	0.82
XP_030042887.1 killer cell lectin-like receptor subfamily F member 1 [Microcaecilia unicolor]	MQSENYYTTLNFDVKKRPHPGMSQGMMEAAQRCPHWHRIALGIGGAGHLLLLGAVIALSLRGFWYHPTGCNGEGPSINTSDLDSSQCLQNQGTHRESKNITAAVSAFTGCAGDWLHHGGKCYFFSMTLKSWSDSRDDCAKRDAQLLEIQDASELVFIHNSRKAKNRAWIGLRITTPGINGDG	-------------------------------RCPHWHRIALGIGGAGHLLL---------RGFWYHPTGCNGEGPSINTSDLDSSQCLQNQGTHRE--NI-AAVSAFTGCAGDWLHHGGKCYFFSMTLKSWSDS-DD------Q---------LVFIHNSRKAKNRAWIGLRITTPGINGD-	0.69
XP_030043127.1 lectin-like [Microcaecilia unicolor]	MMRKITELMLILAVVFTAGQAADEESWCTTGWSCFFSAYYKFVSTPLSWVEAELHCQKLIPGGHLASLHSLEEQQFVLKLSKNNVIWIGASDSYKDRTFFWTDGSAWDYENWHSGEPNNFHGTREACVNSYYFSDDTWNDFICTAKFPFTCKVTGPSCLTNQIVG	------------------------------GWSCFFSAY-K--------------------------------------------IWIGASDSYKDRTFFWTDGSAWDYENWHSGEPNNFHGTREACVNSYYFSDDTWNDFICTAKFPFTCKVTGPSCLTNQIV-	0.75
XP_030043157.1 stress-associated endoplasmic reticulum protein 1-like [Microcaecilia unicolor]	MAGVQRMKVANEKHSKSITQRGNLHHRAAAPPEEKAPVGPWLLALFVFVVCGSAIFQLIQSIRMGG	----------------------------------------WLLALFVFVVC-SAIFQLIQSIRMG-	0.67
XP_030043505.1 trypsin-like [Microcaecilia unicolor]	MKGFLHKETYRDQVQRRIMKFLLLAAFLGAVVAFPIDDYDKIVGGYTCGRNALPYQVSLNAGYHFCGGSLINSQWVVSAAHCYNTRINVRLGEHNIATSEGTEQFIDSAKVIRHPSYNSRTLDNDIMLIKLSSAATLNAYVQPVALPSGCATVGTQCLISGWGNTLSSGTKYPDLLQCLNAPILSSSECINSYPGQITSNMFCAGFLEGGKDSCQNDSGGPVVCNRELQGVVSWGFGCAQKNYPGVYVKVCNYNSWIKNTISTN	----------------------------------------------------------------------------------------------------------------------------------------------------GCATVGTQCLISGWGNTLSSGTKYPDLLQCLNAPILSSSECINSYPGQITSNMFCAGFLEGGKDSCQNDSGGPVVCNRELQGVVSWGFGCAQKNYPGVYVKVCNYNSWIKNTISTN	0.71
XP_030043506.1 anionic trypsin-like [Microcaecilia unicolor]	MKGLLLFALLGAAVAFPLEDDDKIVGGYTCSVPYQVSLNSGYHFCGGSLINNLWVVSAAHCYMSRIQVRLGEHDIETEEGTEQFINSALVIQHPKYNSWYLDNDIMLIKLSTPAILGPHVQVINLPSQCPVPGAQCLISGWGNTLSNGANYPDLLQCVVAPVLTDEECKNAYPGQITENMVCVGYLEGGKDSCQGDSGGPVVSDGELQGIVSWGIGCALEGYPGVYTKVCNYVSWIQDTVAAN	----------------------------T-SV--------GYHFCGGSLINNLW-V-------------------------------------------------------------------------------------------------------------------YP-QITENMVCVGYL--GKDSCQGDSGGPVVSDGELQGIVSWGIGCALEGYPGVYTKVCNYVSWIQDTVAAN	0.72
XP_030044303.1 cortexin-2-like [Microcaecilia unicolor]	MEDILSTTLSASGSALPGTSLTMEQKAAFVFVFFLFIFLGLLIVRCFRILLDPYRSMPSSTWTDYMEKDTFDYRLT	--------------------------------------------RCFRILLDPYRSMPSSTWTDYM----------	0.7
XP_030044373.1 C-type natriuretic peptide 2-like [Microcaecilia unicolor]	MQTMHVLACGLLLAALCIISLAAKPLSQQESLRSILDKELAEYLPSRESGDKVGSLKFQSRLLRDLHNDSRSQRTWARVLNNYPNIKKRNFTNNNKKATTSKGCFGLKLDRIGALSDLGC	-------------------------------------------LP-----DKVGSLKFQSRLLRDLHNDSRSQRTWARVLNNYPNIKKRNFTNNNKKATTSKGCFGLKLDRIGALSDLGC	0.84
XP_030044377.1 C-type natriuretic peptide 2-like [Microcaecilia unicolor]	MQIKHVLACGLLLAALCISLEAKPLNQQKSLRSILDKELAEYLASRDRGDKVGSLKSQSRLLRDLHIDSRSQTTWARVLNNYPNIKKRKVTNNNNKKGSTSKGCFGLKLDRIGALSNLGC	------------------------------------------LA---RGDKVGSLKSQSRLLRDLHIDSRSQTTWARVLNNYPNIKKRKVTNNNNKKGSTSKGCFGLKLDRIGALSNLGC	0.84
XP_030044469.1 phospholipase A2 inhibitor 1-like [Microcaecilia unicolor]	MRTFVTSGVCCILSVLIVTVNSLKCQKCNSITENNCQGTEITCDASRNNCGSMYLKTSTGGVEMNVFIKECIGSSDCDETFFLSAENYNIKGISKCCQSDNCDNGIISRMYPYYIHLDSLVLIPVAQKLCGKATCSAIGQIQDTFRVGALALDFRR	------------------------CQKCNSITE-NCQ----TC--SRNNCGSMYLK----------F-------------F-L---NYNIKGISKCCQSDNCDNGIISRMYPYYIHLDSLVLIPVAQKLCGKATCSAIGQIQDTFRV-----D---	0.65
XP_030044609.1 DNA repair and recombination protein RAD54B-like isoform X2 [Microcaecilia unicolor]	MRRSAAPSQLLGNVTKKPKFLPPAEINADCADKEIVQLNPCSTQENKKQQNNPMTLQAFAQTCDQSVHSIQIWENSNEINCRKNSKGTETPRLEPNSDFL	---------LLGNVTKKPKFLPPAEINADCADKEIVQLNPCS------QQ-NPMTLQAFAQTCDQSVHSIQIWENSNEINCRK-----------------	0.65
XP_030044657.1 antileukoproteinase-like [Microcaecilia unicolor]	MKTRAGIFLIVLLTPWMYSLVNAQCKLEKDGSCPPTSMRMCTDPNAKPECNCDIDCPQKKKCCRDICVNICKDPVKPGYCPVPSTMCSADVPEPTCQSDYDCGGEMKCCTPFCRQECTKPVN	---------------------NAQCKLEKDGSCPPTSMRMCTDPNAKPECNCDIDCPQKKKCCRDICVNICKDPVKPGYCPVPSTMCSADVPEPTCQSDYDCGGEMKCCTPFCRQECTKPVN	0.91
XP_030044717.1 LOW QUALITY PROTEIN: ly6/PLAUR domain-containing protein 6B-like [Microcaecilia unicolor]	MQTSHRLLIACFLQLIPSSKNWVSARNINFYNVIPQIGPTPFPNSFKCFTCENAVDNYNCNRWAEDKWCPPNTKYCLTVHHFASHGRSRSVTKKCATKEECHPVGCHHYRDSGHTECVSCCEGMICNIEVPTNHTNAVFSVMHARRTSDARRRTISIPMLTALMAGMHLL	--------------------------NIN-YNVIPQIGPTPFPNSFKCFTCENAVDNYNCNRWAEDKWCPPNTKYCLTVHHFASHGRSRSVTKKCATKEECHPVGCHHYRDSGHTECVSCCEGMICNIEVP-N-------------------------------------	0.72
XP_030044766.1 histone H3.3 [Microcaecilia unicolor]	MARTKQTARKSTGGKAPRKQLATKAARKSAPSTGGVKKPHRYRPGTVALREIRRYQKSTELLIRKLPFQRLVREIAQDFKTDLRFQSAAIGALQEASEAYLVGLFEDTNLCAIHAKRVTIMPKDIQLARRIRGERA	--------RKSTGGKAPRKQLATKAARKSAPSTGGVKKPHRYRPGTVALREIRRYQKSTELLIRKLPFQRLVREIAQDFKTDLRFQSAAIGALQE-S---L-GLFEDTNLCAIHAKRVTIMPKDIQLARRIRGERA	0.74
XP_030044767.1 histone H3.3 [Microcaecilia unicolor]	MARTKQTARKSTGGKAPRKQLATKAARKSAPSTGGVKKPHRYRPGTVALREIRRYQKSTELLIRKLPFQRLVREIAQDFKTDLRFQSAAIGALQEASEAYLVGLFEDTNLCAIHAKRVTIMPKDIQLARRIRGERA	--------RKSTGGKAPRKQLATKAARKSAPSTGGVKKPHRYRPGTVALREIRRYQKSTELLIRKLPFQRLVREIAQDFKTDLRFQSAAIGALQE-S---L-GLFEDTNLCAIHAKRVTIMPKDIQLARRIRGERA	0.74
XP_030044839.1 interleukin-8-like [Microcaecilia unicolor]	MTAVINECFAAALIVCLFSAALTEAMSLAQMGTELRCQCIKTESRFIHPRLMQIVDLIPSGPHCSNVEVIATLKSGQRVCLEPTAPWVIRIIKKILESSKPTPGSQL	--------------------------------TELRCQCIKTESRFIHPRLMQIVDLIPSGPHCSNVEVIATLKSGQRVCLEPTAPWVIRIIKKILESSKPTPGSQL	0.85
XP_030044840.1 interleukin-8-like [Microcaecilia unicolor]	METKMRMFAAALIVCLLSASLTEAMSLARMGTELRCQCIKTESGFIPRRFIQNVQLFPSGPHCSNAEVIATLKSGQRVCLEPTAPWVERIIKKILEGSDRPESQL	-----------------------------MGTELRCQCIKTESGFIPRRFIQNVQLFPSGPHCSNAEVIATLKSGQRVCLEPTAPWVERIIKKILEGSDRPESQL	0.84
XP_030045014.1 resistin-like [Microcaecilia unicolor]	MKVVGGFLLIVLLKFGFVATSPDQCTISDILSLESFCRSAVSTDLTKPQITCTTISAKGAYATCPSDHIPTSCSCGMACGSWDVQNELMCHCQCNNIDWTAARCCRINAR	------------------------------------CR--VSTDLTKPQITCTTISAKGAYATCPSDHIPTSCSCGMACGSWDVQNELMCHCQCNNIDWTAARCCRINAR	0.84
XP_030045022.1 coiled-coil domain-containing protein 191-like [Microcaecilia unicolor]	MKKTFLAWLDLVNEEKIASWEKQCIAADHHHKRLVLAGFKAWRRFPKLMKEEKEREERREELRKKVAEILPDFRT	-------------------WEKQCIAADHHHKRLVLAGFKAWRRFPKLMKE---------------AEILPDF--	0.75
XP_030045042.1 YY1-associated factor 2-like [Microcaecilia unicolor]	MGDKKSPTRPKRQPKPSSEEGYWDCSVCTFRNSAEAFKCMMCDVRKGTSTRFPKAAKDDTLKNVFCAVPGLSRRLAGLIC	---------------------YWDCSVCTFRNSAEAFKCMMCDVRKGTSTRFPKAAKDDTLKNVFCAVPGLSRRLAGLIC	0.77
XP_030045074.1 histone H3 [Microcaecilia unicolor]	MARTKQTARKSTGGKAPRKQLATKAARKSAPATGGVKKPHRYRPGTVALREIRRYQKSTELLIRKLPFQRLVREIAQDFKTDLRFQSSAVMALQEASEAYLVGLFEDTNLCAIHAKRVTIMPKDIQLARRIRGERA	-------ARKSTGGKAPRKQLATKAARKSAPATGGVKKPHRYRPGTVALREIRRYQKSTELLIRKLPFQRLVREIAQDFKTD-RFQ------------------FEDTNLCAIHAKRVTIMPKDIQLARRIRGERA	0.69
XP_030045075.1 histone H2A type 1-E-like [Microcaecilia unicolor]	MSGRGKQGGKARAKAKTRSSRAGLQFPVGRVHRLLRKGNYAERVGAGAPVYLAAVLEYLTAEILELAGNAARDNKKTRIIPRHLQLAIRNDEELNKLLGRVTIAQGGVLPNIQAVLLPKKTESHKAAKSK	----GKQGGKARAKAKTRSSRAGLQFPVGRVHRLLRKGNYAERVGAGAPVY----------------G-AARDNKKTRIIPRHLQLAIRND----KLLGRVTIAQGGVLPNIQAVLLPKKTESHKAAKS-	0.67
XP_030045076.1 histone H2A type 1-E-like [Microcaecilia unicolor]	MSGRGKQGGKARAKAKTRSSRAGLQFPVGRVHRLLRKGNYAERVGAGAPVYLAAVLEYLTAEILELAGNAARDNKKTRIIPRHLQLAIRNDEELNKLLGRVTIAQGGVLPNIQAVLLPKKTESHKAAKSK	----GKQGGKARAKAKTRSSRAGLQFPVGRVHRLLRKGNYAERVGAGAPVY----------------G-AARDNKKTRIIPRHLQLAIRND----KLLGRVTIAQGGVLPNIQAVLLPKKTESHKAAKS-	0.68
XP_030045077.1 histone H2B type 2-E [Microcaecilia unicolor]	MPEPAKSAPAPKKGSKKAVSKTQKKDGKKRKRSRKESYAIYVYKVLKQVHPDTGISSKAMNIMNSFVNDIFERIAGEASRLAHYNKRSTITSREIQTAVRLLLPGELAKHAVSEGTKAVTKYTSSK	------SAPAPKKGSKKAVSKTQKKDGKKRKRSRKESYAIYVYKVLKQVHPDTGISSKAMNIMNSFVNDIFERIAGEASRLAHYNKRSTITSREIQTAVRLLLPGELAKHAVSEGTKAVTKYTSSK	0.84
XP_030045078.1 histone H2B type 2-E [Microcaecilia unicolor]	MPEPAKSAPAPKKGSKKAVSKTQKKDGKKRKRSRKESYAIYVYKVLKQVHPDTGISSKAMNIMNSFVNDIFERIAGEASRLAHYNKRSTITSREIQTAVRLLLPGELAKHAVSEGTKAVTKYTSSK	------SAPAPKKGSKKAVSKTQKKDGKKRKRSRKESYAIYVYKVLKQVHPDTGISSKAMNIMNSFVNDIFERIAGEASRLAHYNKRSTITSREIQTAVRLLLPGELAKHAVSEGTKAVTKYTSSK	0.84
XP_030045079.1 histone H4 [Microcaecilia unicolor]	MSGRGKGGKGLGKGGAKRHRKVLRDNIQGITKPAIRRLARRGGVKRISGLIYEETRGVLKVFLENVIRDAVTYTEHAKRKTVTAMDVVYALKRQGRTLYGFGG	---RGKGGKGLGKGGAKRHRKVLRDNIQGITKPAIRRLARRGGVKRISGLIYEETRGVLKVFLENVIRDAVTYTEHAKRKTVTAMDVVYALK-QGRTLYGFG-	0.84
XP_030045081.1 histone H4 [Microcaecilia unicolor]	MSGRGKGGKGLGKGGAKRHRKVLRDNIQGITKPAIRRLARRGGVKRISGLIYEETRGVLKVFLENVIRDAVTYTEHAKRKTVTAMDVVYALKRQGRTLYGFGG	---RGKGGKGLGKGGAKRHRKVLRDNIQGITKPAIRRLARRGGVKRISGLIYEETRGVLKVFLENVIRDAVTYTEHAKRKTVTAMDVVYALK-QGRTLYGFG-	0.84
XP_030045082.1 histone H4 [Microcaecilia unicolor]	MSGRGKGGKGLGKGGAKRHRKVLRDNIQGITKPAIRRLARRGGVKRISGLIYEETRGVLKVFLENVIRDAVTYTEHAKRKTVTAMDVVYALKRQGRTLYGFGG	---RGKGGKGLGKGGAKRHRKVLRDNIQGITKPAIRRLARRGGVKRISGLIYEETRGVLKVFLENVIRDAVTYTEHAKRKTVTAMDVVYALK-QGRTLYGFG-	0.84
XP_030045083.1 histone H3 [Microcaecilia unicolor]	MARTKQTARKSTGGKAPRKQLATKAARKSAPATGGVKKPHRYRPGTVALREIRRYQKSTELLIRKLPFQRLVREIAQDFKTDLRFQSSAVMALQEASEAYLVGLFEDTNLCAIHAKRVTIMPKDIQLARRIRGERA	-------ARKSTGGKAPRKQLATKAARKSAPATGGVKKPHRYRPGTVALREIRRYQKSTELLIRKLPFQRLVREIAQDFKTD-RFQ------------------FEDTNLCAIHAKRVTIMPKDIQLARRIRGERA	0.69
XP_030045084.1 histone H2A type 1-E-like [Microcaecilia unicolor]	MSGRGKQGGKARAKAKTRSSRAGLQFPVGRVHRLLRKGNYAERVGAGAPVYLAAVLEYLTAEILELAGNAARDNKKTRIIPRHLQLAIRNDEELNKLLGRVTIAQGGVLPNIQAVLLPKKTESHKAAKSK	-----------------------------------------------------------------------------------------------KLLGRVTIAQGGVLPNIQAVLLPKKTESHKAAKS-	0.7
XP_030045274.1 COX assembly mitochondrial protein 2 homolog [Microcaecilia unicolor]	MHPDLSPHLHTEECNVLIVLLKQCHQENRFMKYFGQCNEADREMRRCLKKEYQENRAKSQARAEEMRKRIMNVSKAD	------------------------HQ--RFMKYFGQCNEADREMRRCLKKEYQ--R-K--------R-RIMNVS---	0.76
XP_030045380.1 histone H3 [Microcaecilia unicolor]	MARTKQTARKSTGGKAPRKQLATKAARKSAPATGGVKKPHRYRPGTVALREIRRYQKSTELLIRKLPFQRLVREIAQDFKTDLRFQSSAVMALQEASEAYLVGLFEDTNLCAIHAKRVTIMPKDIQLARRIRGERA	--------RKSTGGKAPRKQLATKAARKSAPATGGVKKPHRYRPGTVALREIRRYQKSTELLIRKLPFQRLVREIAQDFKTD-RFQ------------------FEDTNLCAIHAKRVTIMPKDIQLARRIRGERA	0.69
XP_030045381.1 histone H3 [Microcaecilia unicolor]	MARTKQTARKSTGGKAPRKQLATKAARKSAPATGGVKKPHRYRPGTVALREIRRYQKSTELLIRKLPFQRLVREIAQDFKTDLRFQSSAVMALQEASEAYLVGLFEDTNLCAIHAKRVTIMPKDIQLARRIRGERA	--------RKSTGGKAPRKQLATKAARKSAPATGGVKKPHRYRPGTVALREIRRYQKSTELLIRKLPFQRLVREIAQDFKTD-RFQ------------------FEDTNLCAIHAKRVTIMPKDIQLARRIRGERA	0.69
XP_030045382.1 histone H3 [Microcaecilia unicolor]	MARTKQTARKSTGGKAPRKQLATKAARKSAPATGGVKKPHRYRPGTVALREIRRYQKSTELLIRKLPFQRLVREIAQDFKTDLRFQSSAVMALQEASEAYLVGLFEDTNLCAIHAKRVTIMPKDIQLARRIRGERA	-------ARKSTGGKAPRKQLATKAARKSAPATGGVKKPHRYRPGTVALREIRRYQKSTELLIRKLPFQRLVREIAQDFKTD-RFQ------------------FEDTNLCAIHAKRVTIMPKDIQLARRIRGERA	0.69
XP_030045384.1 histone H2A type 1-E-like [Microcaecilia unicolor]	MSGRGKQGGKARAKAKTRSSRAGLQFPVGRVHRLLRKGNYAERVGAGAPVYLAAVLEYLTAEILELAGNAARDNKKTRIIPRHLQLAIRNDEELNKLLGRVTIAQGGVLPNIQAVLLPKKTESHKAAKSK	----GKQGGKARAKAKTRSSRAGLQFPVGRVHRLLRKGNYAERVGAGAPVY----------------G-AARDNKKTRIIPRHLQLAIRND----KLLGRVTIAQGGVLPNIQAVLLPKKTESHKAAKS-	0.68
XP_030045385.1 histone H2A type 1-E-like [Microcaecilia unicolor]	MSGRGKQGGKARAKAKTRSSRAGLQFPVGRVHRLLRKGNYAERVGAGAPVYLAAVLEYLTAEILELAGNAARDNKKTRIIPRHLQLAIRNDEELNKLLGRVTIAQGGVLPNIQAVLLPKKTESHKAAKSK	-------GGKARAKAKTRSSRAGLQFPVGRVHRLLRKGNYAERVG-GAP------------------G-AARDNKKTRIIPRHLQLAIRND----KLLGRVTIAQGGVLPNIQAVLLPKKTESHKAAKS-	0.66
XP_030045386.1 histone H2A type 1-E-like [Microcaecilia unicolor]	MSGRGKQGGKARAKAKTRSSRAGLQFPVGRVHRLLRKGNYAERVGAGAPVYLAAVLEYLTAEILELAGNAARDNKKTRIIPRHLQLAIRNDEELNKLLGRVTIAQGGVLPNIQAVLLPKKTESHKAAKSK	----GKQGGKARAKAKTRSSRAGLQFPVGRVHRLLRKGNYAERVGAGAPVY----------------G-AARDNKKTRIIPRHLQLAIRND----KLLGRVTIAQGGVLPNIQAVLLPKKTESHKAAKS-	0.67
XP_030045387.1 histone H2A type 1-E-like [Microcaecilia unicolor]	MSGRGKQGGKARAKAKTRSSRAGLQFPVGRVHRLLRKGNYAERVGAGAPVYLAAVLEYLTAEILELAGNAARDNKKTRIIPRHLQLAIRNDEELNKLLGRVTIAQGGVLPNIQAVLLPKKTESHKAAKSK	----GKQGGKARAKAKTRSSRAGLQFPVGRVHRLLRKGNYAERVGAGAPVY----------------G-AARDNKKTRIIPRHLQLAIRND----KLLGRVTIAQGGVLPNIQAVLLPKKTESHKAAKS-	0.68
XP_030045388.1 histone H2A type 1-E-like [Microcaecilia unicolor]	MSGRGKQGGKARAKAKTRSSRAGLQFPVGRVHRLLRKGNYAERVGAGAPVYLAAVLEYLTAEILELAGNAARDNKKTRIIPRHLQLAIRNDEELNKLLGRVTIAQGGVLPNIQAVLLPKKTESHKAAKSK	----GKQGGKARAKAKTRSSRAGLQFPVGRVHRLLRKGNYAERVGAGAPVY----------------G-AARDNKKTRIIPRHLQLAIRND----KLLGRVTIAQGGVLPNIQAVLLPKKTESHKAAKS-	0.67
XP_030045389.1 histone H2A type 1-E-like [Microcaecilia unicolor]	MSGRGKQGGKARAKAKTRSSRAGLQFPVGRVHRLLRKGNYAERVGAGAPVYLAAVLEYLTAEILELAGNAARDNKKTRIIPRHLQLAIRNDEELNKLLGRVTIAQGGVLPNIQAVLLPKKTESHKAAKSK	----GKQGGKARAKAKTRSSRAGLQFPVGRVHRLLRKGNYAERVGAGAPVY----------------G-AARDNKKTRIIPRHLQLAIRND----KLLGRVTIAQGGVLPNIQAVLLPKKTESHKAAKS-	0.67
XP_030045390.1 histone H2A type 1-E-like [Microcaecilia unicolor]	MSGRGKQGGKARAKAKTRSSRAGLQFPVGRVHRLLRKGNYAERVGAGAPVYLAAVLEYLTAEILELAGNAARDNKKTRIIPRHLQLAIRNDEELNKLLGRVTIAQGGVLPNIQAVLLPKKTESHKAAKSK	----GKQGGKARAKAKTRSSRAGLQFPVGRVHRLLRKGNYAERVGAGAPVY----------------G-AARDNKKTRIIPRHLQLAIRND----KLLGRVTIAQGGVLPNIQAVLLPKKTESHKAAKS-	0.67
XP_030045392.1 histone H2A type 1-E-like [Microcaecilia unicolor]	MSGRGKQGGKARAKAKTRSSRAGLQFPVGRVHRLLRKGNYAERVGAGAPVYLAAVLEYLTAEILELAGNAARDNKKTRIIPRHLQLAIRNDEELNKLLGRVTIAQGGVLPNIQAVLLPKKTESHKAAKSK	----GKQGGKARAKAKTRSSRAGLQFPVGRVHRLLRKGNYAERVGAGAPVY----------------G-AARDNKKTRIIPRHLQLAIRND----KLLGRVTIAQGGVLPNIQAVLLPKKTESHKAAKS-	0.67
XP_030045393.1 histone H2B type 2-E [Microcaecilia unicolor]	MPEPAKSAPAPKKGSKKAVSKTQKKDGKKRKRSRKESYAIYVYKVLKQVHPDTGISSKAMNIMNSFVNDIFERIAGEASRLAHYNKRSTITSREIQTAVRLLLPGELAKHAVSEGTKAVTKYTSSK	---------------------------------RKESYAIYVYKVLKQVHPDT-I----MN-M--FV-DIFERIA---SRLAHYN--STITSREIQTAVRLLLPGELAKHAVSEGTKAVTKYTSSK	0.64
XP_030045394.1 histone H2B type 2-E [Microcaecilia unicolor]	MPEPAKSAPAPKKGSKKAVSKTQKKDGKKRKRSRKESYAIYVYKVLKQVHPDTGISSKAMNIMNSFVNDIFERIAGEASRLAHYNKRSTITSREIQTAVRLLLPGELAKHAVSEGTKAVTKYTSSK	-----KSAPAPKKGSKKAVSKTQKKDGKKRKRSRKESYAIYVYKVLKQVHPDTGISSKAMNIMNSFVNDIFERIAGEASRLAHYNKRSTITSREIQTAVRLLLPGELAKHAVSEGTKAVTKYTSSK	0.82
XP_030045396.1 histone H2B type 2-E [Microcaecilia unicolor]	MPEPAKSAPAPKKGSKKAVSKTQKKDGKKRKRSRKESYAIYVYKVLKQVHPDTGISSKAMNIMNSFVNDIFERIAGEASRLAHYNKRSTITSREIQTAVRLLLPGELAKHAVSEGTKAVTKYTSSK	------SAPAPKKGSKKAVSKTQKKDGKKRKRSRKESYAIYVYKVLKQVHPDTGISSKAMNIMNSFVNDIFERIAGEASRLAHYNKRSTITSREIQTAVRLLLPGELAKHAVSEGTKAVTKYTSSK	0.84
XP_030045397.1 histone H2B type 2-E [Microcaecilia unicolor]	MPEPAKSAPAPKKGSKKAVSKTQKKDGKKRKRSRKESYAIYVYKVLKQVHPDTGISSKAMNIMNSFVNDIFERIAGEASRLAHYNKRSTITSREIQTAVRLLLPGELAKHAVSEGTKAVTKYTSSK	------SAPAPKKGSKKAVSKTQKKDGKKRKRSRKESYAIYVYKVLKQVHPDTGISSKAMNIMNSFVNDIFERIAGEASRLAHYNKRSTITSREIQTAVRLLLPGELAKHAVSEGTKAVTKYTSSK	0.84
XP_030045398.1 histone H2B type 2-E [Microcaecilia unicolor]	MPEPAKSAPAPKKGSKKAVSKTQKKDGKKRKRSRKESYAIYVYKVLKQVHPDTGISSKAMNIMNSFVNDIFERIAGEASRLAHYNKRSTITSREIQTAVRLLLPGELAKHAVSEGTKAVTKYTSSK	-------APAPKKGSKKAVSKTQKKDGKKRKRSRKESYAIYVYKVLKQVHPDTGISSKAMNIMNSFVNDIFERIAGEASRLAHYNKRSTITSREIQTAVRLLLPGELAKHAVSEGTKAVTKYTSSK	0.84
XP_030045399.1 histone H4 [Microcaecilia unicolor]	MSGRGKGGKGLGKGGAKRHRKVLRDNIQGITKPAIRRLARRGGVKRISGLIYEETRGVLKVFLENVIRDAVTYTEHAKRKTVTAMDVVYALKRQGRTLYGFGG	---RGKGGKGLGKGGAKRHRKVLRDNIQGITKPAIRRLARRGGVKRISGLIYEETRGVLKVFLENVIRDAVTYTEHAKRKTVTAMDVVYALK-QGRTLYGFG-	0.84
XP_030045400.1 histone H4 [Microcaecilia unicolor]	MSGRGKGGKGLGKGGAKRHRKVLRDNIQGITKPAIRRLARRGGVKRISGLIYEETRGVLKVFLENVIRDAVTYTEHAKRKTVTAMDVVYALKRQGRTLYGFGG	---RGKGGKGLGKGGAKRHRKVLRDNIQGITKPAIRRLARRGGVKRISGLIYEETRGVLKVFLENVIRDAVTYTEHAKRKTVTAMDVVYALK-QGRTLYGFG-	0.84
XP_030045401.1 histone H4 [Microcaecilia unicolor]	MSGRGKGGKGLGKGGAKRHRKVLRDNIQGITKPAIRRLARRGGVKRISGLIYEETRGVLKVFLENVIRDAVTYTEHAKRKTVTAMDVVYALKRQGRTLYGFGG	---RGKGGKGLGKGGAKRHRKVLRDNIQGITKPAIRRLARRGGVKRISGLIYEETRGVLKVFLENVIRDAVTYTEHAKRKTVTAMDVVYALK-QGRTLYGFG-	0.84
XP_030045402.1 histone H4 [Microcaecilia unicolor]	MSGRGKGGKGLGKGGAKRHRKVLRDNIQGITKPAIRRLARRGGVKRISGLIYEETRGVLKVFLENVIRDAVTYTEHAKRKTVTAMDVVYALKRQGRTLYGFGG	MSGRGKGGKGLGKGGAKRHRKVLRDNIQGITKPAIRRLARRGGVKRISGLIYEETRGVLKVFLENVIRDAVTYTEHAKRKTVTAMDVVYALK-QGRTLYGFG-	0.79
XP_030045403.1 histone H4 [Microcaecilia unicolor]	MSGRGKGGKGLGKGGAKRHRKVLRDNIQGITKPAIRRLARRGGVKRISGLIYEETRGVLKVFLENVIRDAVTYTEHAKRKTVTAMDVVYALKRQGRTLYGFGG	---RGKGGKGLGKGGAKRHRKVLRDNIQGITKPAIRRLARRGGVKRISGLIYEETRGVLKVFLENVIRDAVTYTEHAKRKTVTAMDVVYALK-QGRTLYGFG-	0.84
XP_030045404.1 histone H4 [Microcaecilia unicolor]	MSGRGKGGKGLGKGGAKRHRKVLRDNIQGITKPAIRRLARRGGVKRISGLIYEETRGVLKVFLENVIRDAVTYTEHAKRKTVTAMDVVYALKRQGRTLYGFGG	---RGKGGKGLGKGGAKRHRKVLRDNIQGITKPAIRRLARRGGVKRISGLIYEETRGVLKVFLENVIRDAVTYTEHAKRKTVTAMDVVYALK-QGRTLYGFG-	0.84
XP_030045405.1 histone H4 [Microcaecilia unicolor]	MSGRGKGGKGLGKGGAKRHRKVLRDNIQGITKPAIRRLARRGGVKRISGLIYEETRGVLKVFLENVIRDAVTYTEHAKRKTVTAMDVVYALKRQGRTLYGFGG	---RGKGGKGLGKGGAKRHRKVLRDNIQGITKPAIRRLARRGGVKRISGLIYEETRGVLKVFLENVIRDAVTYTEHAKRKTVTAMDVVYALK-QGRTLYGFG-	0.84
XP_030045406.1 histone H4 [Microcaecilia unicolor]	MSGRGKGGKGLGKGGAKRHRKVLRDNIQGITKPAIRRLARRGGVKRISGLIYEETRGVLKVFLENVIRDAVTYTEHAKRKTVTAMDVVYALKRQGRTLYGFGG	---RGKGGKGLGKGGAKRHRKVLRDNIQGITKPAIRRLARRGGVKRISGLIYEETRGVLKVFLENVIRDAVTYTEHAKRKTVTAMDVVYALK-QGRTLYGFG-	0.77
XP_030045407.1 histone H2B type 2-E [Microcaecilia unicolor]	MPEPAKSAPAPKKGSKKAVSKTQKKDGKKRKRSRKESYAIYVYKVLKQVHPDTGISSKAMNIMNSFVNDIFERIAGEASRLAHYNKRSTITSREIQTAVRLLLPGELAKHAVSEGTKAVTKYTSSK	------SAPAPKKGSKKAVSKTQKKDGKKRKRSRKESYAIYVYKVLKQVHPDTGISSKAMNIMNSFVNDIFERIAGEASRLAHYNKRSTITSREIQTAVRLLLPGELAKHAVSEGTKAVTKYTSSK	0.84
XP_030045409.1 histone H2B type 2-E [Microcaecilia unicolor]	MPEPAKSAPAPKKGSKKAVSKTQKKDGKKRKRSRKESYAIYVYKVLKQVHPDTGISSKAMNIMNSFVNDIFERIAGEASRLAHYNKRSTITSREIQTAVRLLLPGELAKHAVSEGTKAVTKYTSSK	------SAPAPKKGSKKAVSKTQKKDGKKRKRSRKESYAIYVYKVLKQVHPDTGISSKAMNIMNSFVNDIFERIAGEASRLAHYNKRSTITSREIQTAVRLLLPGELAKHAVSEGTKAVTKYTSSK	0.84
XP_030045410.1 histone H2A type 1-E-like isoform X1 [Microcaecilia unicolor]	MSGRGKQGGKARAKAKTRSSRAGLQFPVGRVHRLLRKGNYAERVGAGAPVYLAAVLEYLTAEILELAGNAARDNKKTRIIPRHLQLAIRNDEELNKLLGRVTIAQGGVLPNIQAVLLPKKTESHKAAKSK	----GKQGGKARAKAKTRSSRAGLQFPVGRVHRLLRKGNYAERVGAGAPVY----------------G-AARDNKKTRIIPRHLQLAIRND----KLLGRVTIAQGGVLPNIQAVLLPKKTESHKAAKS-	0.68
XP_030045411.1 histone H2A type 1-E-like isoform X2 [Microcaecilia unicolor]	MSGRGKQGGKARAKAKTRSSRAGLQFPVGRVHRLLRKGNYAERVGAGAPVYLAAVLEYLTAEILELAGNAARDNKKTRIIPRHLQLAIRNDEELNKLLGRVTIAQGGVLPNIQAVLLKATRLV	----GKQGGKARAKAKTRSSRAGLQFPVGRVHRLLRKGNYAERVGAGAPV-------------------AARDNKKTRIIPRHLQLAIRND----KLLGRVTIAQGGVLPNIQAVLLK-TRLV	0.64
XP_030045413.1 histone H4-like [Microcaecilia unicolor]	MSGRGKGGKGLGKGGAKRHRKVLRDNIQGITKPAIRRLARRGGVKRISGLIYEETRGVLKVFLENVIRDAVTYTEHAKRKTVTAMDVVYALKRQGRNPVWFRRLKDRSLLNLSNQLKGSFKSTHTFITEL	----GKGGKGLGKGGAKRHRKVLRDNIQGITKPAIRRLARRGGVKRISGLIYEETRGVLKVFLE-VIRDAVTYT---K-KTVTA-DV--------RNPVWFRRLK--S----------------------	0.67
XP_030045660.1 2-iminobutanoate/2-iminopropanoate deaminase-like [Microcaecilia unicolor]	MGRLVSFKGYCNPGDKVRFAWRNYSFTMAATIRKVIYTPRAPIRKGIYSQAVVVDKTMYICGVVGIDVATGQLVPGGVLEETKQSTKLSAVC	---LVSFKGYCNPGDKVRFAWRNYSFTMAATIRKVIYTPRAPIRKGIYSQAVVVDKTMYICGVVGIDVATGQLVPGGVL-----STK-SAV-	0.78
XP_030045725.1 regenerating islet-derived protein 4-like [Microcaecilia unicolor]	MSKTWSNSESYCRSLGRGVHLASIHGKSEANIIGSYIAAHDKNKPVWIGLHNPVQTHLWEWSDGSMYKYRAWEKTLLIMMSVMFLGLLLSCIALTEVLAGPAARSSCPPGWFYYKSNCYGYFRFKASWFDAEFECQSYGHGAHLASILDSSEAAILASHILAYQRNQVVWIGLHDPEENRRWKWADGSMYNYRSWEAQQPDNHENNEYCVELRCNEKFLKWNDSPCESASHFICKFKP	----------------RGVHLASIH-----NIIGSY-AAHDKNKPVWIGLH----------------------------------------------------RSSCPPGWFYYKSNCYGYFRFK-SW--------------------------------------------LHD------WKWADGSMYN---------------------RCNEKFLKWNDSPCESASHFICKFKP	0.66
XP_030045727.1 late histone H2B.L4-like [Microcaecilia unicolor]	MSVEPGKKKVKNVGEKRVSKKKGKRRETYSVYIYKVLKQVHPDTGISSKAMSIMNSFVNDVFERIATEASRLAQYNQRATITSREVQTAVRLLLPGELAKHAVSEGTKAVTKYTSSK	-------KKVKNVGEKRVSKKKGKRRETYSVYIYKVLKQVHPDTGISSKAMSIMNSFVNDVFERIATEASRLAQYNQRATITSREV--AVRLLLPGELAKHAVSEGTKAVTKYTSSK	0.74
XP_030045752.1 cathelicidin-related peptide Na_CRAMP-like [Microcaecilia unicolor]	MGSWLKVVLVISVATVVTPVITTPIFQNIQDAKFIALAISFYNKQANAPSIFKLLEADPLYRLGESVQQMTFRIKETVCQKSEIQSMKECDFKVDGLVKTCLAYFSQQEPHLSGLTCHSVNQKQIRVRRSNPKRECFRRGNKVICRTPSPHRIGSGSTIERVKHHGEIKILPTKAHQK	-------------------------------------------------------------------------------------------------------------------T------KQIRVRRSNPKRECFRRGNKVICRTPSPHRIGSGSTIERVKHHGEIKILPTKAHQ-	0.8
XP_030045753.1 cathelicidin-6-like [Microcaecilia unicolor]	MMSWLTTLLVTWVASVVTSARIPPISSDIQDLDSIILAIDFYNQEQNETSIFKLLDVDNNRRLDDSANNQELNFRIKQTVCQKTETQNTEECEFKEDGLVKDCSAYVLYEKEFKQETGATIITCEPVDQQKTVKSRKKRFSRRRGRKRLRFGMYTLIGHVDKKKNNYGLIWAK	------------------------------------------------------------------------------------------------------------------------------------------RFSRRRGRKRLRFGMYTLIGHVDKKKNNYGLIWAK	0.82
XP_030045755.1 cathelicidin-related peptide Na_CRAMP-like [Microcaecilia unicolor]	MGSWLKVVLVISVATVVTPVTTTPIFQNIQDAKFIALAISFYNKQANVPSIFKLLEADPIYRLGESVQQMTFRIKETVCQKSETQSMKECDFKVDGLVKTCLAYFSQQEPHLSGFTCHTVNQKQIRVRRSNPKRECFRRGNKVICKTPSPRRTTSPPKIGSGSHIAGIDDVPHLLERSKILPAKEHQK	------------------------------------------------------------------------------------------------------------------FTCHTVNQKQIRVRRSNPKRECFRRGNKVICKTPSPRRTTSPPKIGSGSHIAGIDDVPHLLERSKILPAKEHQ-	0.76
XP_030045798.1 acyl-CoA-binding domain-containing protein 7 [Microcaecilia unicolor]	MSLQADFQKAADNVRKLKAKPTDDEMSELYSLYKQSLVGDVNKADPGASDAVAKAKWDAWNKKKGMSKDDAMKAYIAKSKEMVAKYGVAS	------F---ADNVRKLKAKPTDDEMSELYSLYK-SLVGDVNKADPGASDAVAKAKWDAWNKKKGMSKDDAMKAYIAKSKEMVAKYGVA-	0.76
XP_030045826.1 pro-neuropeptide Y isoform X1 [Microcaecilia unicolor]	MQGSMRLWLNVLTFTLSLLICLGTLADAYPSKPDNPGEDAPAEDMAKYYSALRHYINLITRQRYGKRSNPETMVSDVWWRESTENIPRSRFEDPSMW	----------------------------------------------KYYSALRHYINLITRQRYGKRSNPETMVSDVWWRESTENIPRSRFEDPSMW	0.68
XP_030045827.1 pro-neuropeptide Y isoform X2 [Microcaecilia unicolor]	MQGSMRLWLNVLTFTLSLLICLGTLADAYPSKPDNPGEDAPAEDMAKYYSALRHYINLITRQRYGKRSNPETMVSDVWWRESTENIPRSR	----------------------------------------------------------------------------------------S-	0.51
XP_030045843.1 matrix Gla protein [Microcaecilia unicolor]	MRVLFIVALLAILAVVTFCSDSHESYESFERYHPFVNRRKANNFIGLQQKKARTYERIRELNKSPKERQREICEDHDLCELYAMRHGFQKAYKRYFGQKYGRGK	----------------------------FERYHPFVNRRKANNFIGLQQKKARTYERIRELNKSPKERQREICEDHDLCELYAMRHGFQKAYKRYFGQKYGRG-	0.83
XP_030045844.1 matrix Gla protein [Microcaecilia unicolor]	MRVLFIVALLAILAVVTFCSDSHESYESFERYHPFVNRRKANNFIGLQQKKARTYERIRELNKSPKERQREICEDHDLCELYAMRHGFQKAYKRYFGQKYGRGK	----------------------------FERYHPFVNRRKANNFIGLQQKKARTYERIRELNKSPKERQREICEDHDLCELYAMRHGFQKAYKRYFGQKYGRG-	0.83
XP_030045891.1 lymphocyte antigen 6E-like [Microcaecilia unicolor]	MTIIVNGSLIINGPTLKCYTCTKKQSNSDCLIETQCSGSLRYCETIVTRTKQGFSVITNIWKYCSSRCMTSVQYNNGLKSTISCCDTALCNISGAMSVKISYLALVISVGFGGSLLRSGL	------------------YTCTKKQSNSDCLIETQCSGSLRYCETIVTRTKQGFSVITNIWKYCSSRCMTSVQYNNGLKSTISCCDTALCNIS----------------GFGGSLLRSGL	0.69
XP_030045911.1 neuritin [Microcaecilia unicolor]	MGLTLNCRYISIILAVQLAYLVQAVRAAGKCDAVFKGFSDCLLSLGDKMANYPQDLDDDRNLKTICSYWNDFHVCTITALADCQEGATEIWEKLKKESKNLDIQGSLFELCGGNNGAATSVLHLLPTFFPLLLVSLSVLVTWLTF	--------------------------AAGKCDAVFKGFSDCLLSLGDKMANYPQDLDDDRNLKTICSYWNDFHVCTITALADCQEGATEIWEKLKKESKNLDIQGSLFELCGGN---A--------------------LVTWLTF	0.72
XP_030045998.1 lymphotactin-like isoform X1 [Microcaecilia unicolor]	MKLAMSVLVCFILYTVSTIKAGPGGHQVKIKSCTDIKSNKPLNVKRISRFIHQKTPIAAIMFITNRNIMICVDPKLEWVQLAIKTINSRKTSRRRPKN	---------------------GPGGHQVKIKSCTDIKSNKPLNVKRISRFIHQKTPIAAIMFITNRNIMICVDPKLEWVQLAIKTINSRKTSRRRPKN	0.91
XP_030045999.1 lymphotactin-like isoform X2 [Microcaecilia unicolor]	MKLAMSVLVCFILYTVSTIKGPGGHQVKIKSCTDIKSNKPLNVKRISRFIHQKTPIAAIMFITNRNIMICVDPKLEWVQLAIKTINSRKTSRRRPKN	---------------------PGGHQVKIKSCTDIKSNKPLNVKRISRFIHQKTPIAAIMFITNRNIMICVDPKLEWVQLAIKTINSRKTSRRRPKN	0.91
XP_030046082.1 ly6/PLAUR domain-containing protein 2-like [Microcaecilia unicolor]	MKMKKGVLILPLVILFCMELAVSLECYYCPSSVPSAECTDLYNCTKNETICMTKIMDSDFGFPFQGTENVIKGCVKECIPTDLDTIGQAHPVFCCNKDRCNNRGLSNQGLSEATSTGASHVALPIPITLCYFLHIIVL	---------------------------------------------------M---------FPFQ----VIKGCVKECIPTD-D-I-QAHPVFCCNKDRCNNRGLSNQG-S---------------------------	0.61
XP_030046088.1 bucandin-like [Microcaecilia unicolor]	MRNFLFSLLIAALCLHTADFLKCYTCKHTIELNNSDCLIETTCSSEDKYCRTTLASAHEETAISKQCEPTCTPGEVEVDELKISDSCCQTDLCNYNAGISGSEGMA	-------------------FLKCYTCKHTIELNNSDCLIETTCS-----CRT-----------------------------KISDSCCQTDLCNYNAGISGSEGMA	0.73
XP_030046154.1 lectin-like [Microcaecilia unicolor]	MNFPTLLYLLVLFIVGGNCTSENCLCAQGFCASGWVQYKDACYANFTTRLSWANAETKCQSLNSHLASIHSVEENDFIYVLMGKIHNHGTGQAYWIGGHDTFKEGKYMWTDGSAWDFAKFGSGQPDNLGNENYIGSWYPENDHITWNDYPTSYSFPFVCKYQLRNRICCDSGYIKPVKT	--------------------SENCLCAQGFCASGWVQYKDACYAN-T-------------------------------------IHNHGTGQAYWIGGHDTFKEGKYMWTDGSAWDFAKFGSGQPDNLGNENYIGSWYPENDHITWNDYPTSYSFPFVCKYQLRNRICCDSGYIKPVK-	0.77
XP_030046206.1 mitochondrial import inner membrane translocase subunit Tim10-like [Microcaecilia unicolor]	MGNQELRTALFAVFVLSGGPRNTAGTKDDKCLPPEVCSPLTIRKLSCQRESLCAWIDVSKYLDIHEHMGKKLTELSLQDGGADEEKGAGPVQ	-----------------------AGTKDDKCLPPEVCSPLTIRKLSCQRESLCAWIDVSKYLDIHEHMGKKLTELS-Q--------------	0.77
XP_030046251.1 kunitz-type U19-barytoxin-Tl1a-like [Microcaecilia unicolor]	MKNCSTLAEKLYPDDDRVCQLEKDVGDCKGHCLLWAFNHNLKTCEKSFYGGCGGNGNRFFTKKLCYERCAPEKEHGLENDLDSDDVDIGLILGVTIGCVAAVVLVVALIIFLKNRK	--------------------L-K-VGDCKGHCLLWAFNHNLKTCEKSFYGGCGGNGNRFFTKKLCYERCAPE--------------------------------------FLK-R-	0.67
XP_030046286.1 cocaine- and amphetamine-regulated transcript protein-like [Microcaecilia unicolor]	MESSALLIKLFCASLLLSSLCRGQSSREMSSEEYREKKSPSSAEKELVEAMEELLGKFQNKYPSYQKKAAQIPMCDIGERCAVKQGPRIGKLCDCSRGAICNTFLLKCI	---------------------------------------------------------FQNKYPSYQKKAAQIPMCDIGERCAVKQGPRIGKLCDCSRGAICNTFLLKCI	0.85
XP_030046287.1 cocaine- and amphetamine-regulated transcript protein-like [Microcaecilia unicolor]	MESSRMLLVAVGCWLLLLAAVCAQETSELETRALRDFYPKDSIPSSEKELLGALQEVLEKLQSKRVPVWEKKFGQVPTCDIGEQCAVRKASRIGKLCNCPRGAVCNFFLLKCL	-----------------------------------------------------------------VPVWEKKFGQVPTCDIGEQCAVRKASRIGKLCNCPRGAVCNFFLLKCL	0.84
XP_030046406.1 C-X-C motif chemokine 13 [Microcaecilia unicolor]	MKSSAAVLMFTLLLITQDAHGLFEDPRCERCKCQKTTKSFVHPKKISDIRLLLPTHCCPRKEMILTLKTGSLVCVDPAAKWINTLLKIIQENKKESENPSL	----------------------FEDPRCERCKCQKTTKSFVHPKKISDIRLLLPTHCCPRKEMILTLKTGSLVCVDPAAKWINTLLKIIQE----------	0.85
XP_030046482.1 interleukin-8-like [Microcaecilia unicolor]	METKMRMFAAALIVCLLSASLTEAMSLARMGTELRCQCIKTESGFIPRRFIQNVQLFPSGPHCSNAEVIATLKSGQRVCLEPTAPWVERIIKKILEGSDRPESQL	-----------------------------MGTELRCQCIKTESGFIPRRFIQNVQLFPSGPHCSNAEVIATLKSGQRVCLEPTAPWVERIIKKILEGSDRPESQL	0.84
XP_030047696.1 LOW QUALITY PROTEIN: regenerating islet-derived protein 4-like [Microcaecilia unicolor]	MSKTWSNSESYCRSLGRGVHLASIHGKSEANIIGSYIAAHDKNKPVWIGLHNPVQTHLWEWSDGSMYKYRAWEKTLLIMMSVMFLGLLLSCIALTEVLAGPAARSSCPPGWFYYKSNCYGYFRFKASWFDAEFECQSYGHGAHLASIXDSSEAAILASHXLAYQRNQVVWIGLHDPEENRRWKWADGSMYNYRSWEAQQPDNHGNNEYCVELRCNEKFLKWNDRPCETASHFICKFKP	----------------RGVHLASIH-----NIIGSY-AAHDKNKPVWIGLH----------------------------------------------------RSSCPPGWFYYKSNCYGYFRFKASWF------------------------------------------GLH-----RRWKWADGSMYNYRSWEAQQP--------CV-LRCNEKFLKWNDRPCETASHFICKFKP	0.68
XP_030047740.1 C-C motif chemokine 19-like [Microcaecilia unicolor]	MFLRISLLCLIVLCCWETMQVFGNNSTPDCCLLVSHKPIKRHLVKSYRIQTADNSCTRNAVVFITRKNKALCAPPGVEWVKALVAKLDKAHKQKAARRKQKTA	--------------CWETMQVFGNNSTPDCCLLVSHKPIKRHLVKSYRIQTADNSCTRNAVVFITRKNKALCAPPGVEWVKALVAKLDKAHKQKAARRKQKTA	0.91
XP_030047741.1 C-C motif chemokine 28-like [Microcaecilia unicolor]	MKTLLFIACLLLLFLPSLEGMPTVNLNCCTTVAKHIPKHIFKHVRHLNFQMTDWNCNLPAAVLIFKNQMMCLDPKNKDFRIWLRRRRLTQGPKLANGQRKKIQ	-------------------------LNCCTTVAKHIPKHIFKH-R-LN------------------------D---KDFRIWLRRRRLTQGPKLANGQRKKI-	0.75
XP_030047892.1 lysozyme C-1-like [Microcaecilia unicolor]	MAPRTALIIVKALALAFLLGLVVLKSEAKVFSKCELASAFKRGGLDGYYGYSLANWMCLAYYESRYNTAAVNNNGPSRDYGVFQINSYWWCNDGQTSGSKNACGISCSNFLNDDISDDIVCAKRVVRDPQGMNAWVAWKNYCKGKDVSSFTSGCAL	-----------------------------VFSKCELASAFKRGGLDGYYGYSLANWMCLAYYESRYNTAAVNNNGPSRDYGVFQINSYWWCNDGQTSGSKNACGISCSNFLNDDISDDIVCAKRVVRDPQGMNAWVAWKNYCKGKDVSSFTSGCAL	0.92
XP_030047916.1 IQ motif and SEC7 domain-containing protein 2-like [Microcaecilia unicolor]	MEGGPGPGSGPGPGGESPNRAVEYLLELNNIIESQQKLLETQRRRIEELEVQLERLSQENRDLREGQNREREQQHRHHRDYHCRDPPQPVRDPPHYPNREPQHYREGQCQQQQQQHRHRERDQEREGHYSGRERSQRSRGASRSSSPGGGGGHSTSTSTSPATTLQRKSDGENSRTVSISNKLNLNLMKLSTAMTPFCDHRKHMMTEAAYLESMLLLLAFLKHRL	---------------------------------------------------------------------------RHHRDYHCRDPPQPVRDPPHYP-RE-QHYR-GQCQQ-------------------------------------------------------------------------------------------------------------LK-R-	0.57
XP_030048001.1 platelet basic protein-like [Microcaecilia unicolor]	MHTASRVSGSHSHKEAETILEPTHTQKLEATTGTHTDTEEQCNRNPLTQRSRSFSTSQEARSHSSYKLNCEKQENNSSIDMQSKFHTLILAICLMSVALSEAMSVPRMYTPRMVKSRMGMELRCQCIKTESNFIHPHNIQIVELYPSGAQCANVEVIATLKDGQRVCLDPSAPWVRKIIQKISESSPDINNESQ	--------------------------------------------------------------------------------------------------------------------RMGMELRCQCIKTESNFIHPHNIQIVELYPSGAQCANVEVIATLKDGQRVCLDPSAPWVRKIIQKISESSPDI-----	0.76
XP_030048129.1 endothelial cell-specific molecule 1 [Microcaecilia unicolor]	MRSRLFLAMLLVSVHTGSTRSAPYAVDCPGHCVSNECKSTLRCARTVLDDCGCCRVCAAGVGETCYRTVSGMDGVKCGPGLRCHFYSEEDDFGDEFGICKECPYGTHGMECRKTCSCPSGVCDRVSGKCLKFPFFQQSAPKPPKKPHSESDSASGDGNDVKEELMNGKTIHSSGMKWLNPR	---------------------APYAVDCPGHCVSNECKSTLRCARTVLDDCGCCRVCAAGVGETCYRTVSGMDGVKCGPGLR-H-------F---FGICKECPYGTHGMECRKTCSCPSGVCDRVSGKCLKFPFFQQSAPKP----------------------M---TI-SSGMKWLNPR	0.73
XP_030048131.1 granzyme A-like [Microcaecilia unicolor]	MALVLTLSLCAAAFLLNIHGGLGVKIIGGKEAKPHSMPFMALIKGKSICGGILIKSNWVLTAAHCETDNYTKVILGVHSISTKEKEQQMFSIKKRIPHQCFDKKTGENDLMLLQLTGNAKLNKNVKLHSLPKNGEDIKARTKCEVAGWGITNNKATSGSDKLMHVTITILDRQMCSDMKHYNFNPVITNNMLCAGDKRGRKDTCSGDSGGPLLCKGILRGITSFGHKICGDPKKPGIYTRLTDTYLSWIKKTIGGDF	--------------------GLGVKIIGGKEAKPHSMPFMALIKGKSICGGILIKSNWV---------------------------------------------------------------------------------------GWG-------------------------------------------------GRKDTCSGDSGGPLLCKGILRGITSFGHKICGDPKKPGIYTRLTDTYLSWIKKTIGGDF	0.77
XP_030048153.1 protein S100-Z [Microcaecilia unicolor]	MPTQLETAMDTLIKIFHHYSGKEGDKYKLNKGELKQLLQCELTDFLACQKDPQLVDKIMKDLDTNKDNEVDFNEFVVLVAALTVACNDFFEEQLKKKGKLKDCN	--------------IFHHYSGKEGDKYKLNKGELKQLLQCELTDFLACQKDPQLVDKI--------------------------ACNDFFEEQLKKKGKLKDCN	0.68
XP_030048155.1 protein S100-Z [Microcaecilia unicolor]	MPTQLETAMDTLIKIFHHYSGKEGDKYKLNKGELKQLLQCELTDFLACQKDPQLVDKIMKDLDTNKDNEVDFNEFVVLVAALTVACNDFFEEQLKKKGKLKDCN	-------------KIFHHYSGKEGDKYKLNK---KQLLQCELTDFLAC-K---L------------------------------ACNDFFEEQLKKKGKLKDCN	0.64
XP_030048164.1 cocaine- and amphetamine-regulated transcript protein [Microcaecilia unicolor]	MESSRVCVVTCCSAFLLLLLGASCQETGELEPRSLDFYTTVESTSREKELLEALQEVLEKLKSKRIPSYEKKYGQVPMCEAGDQCAVRKGPRIGKLCDCPRRTSCNTYLLKCL	----------------------------------------------------------------RIPSYEKKYGQVPMCEAGDQCAVRKGPRIGKLCDCPRRTSCNTYLLKCL	0.9
XP_030048258.1 chemokine-like protein TAFA-1 [Microcaecilia unicolor]	MRLQLGFCLTGWAFLLLMSNVHGQHLHLSPQWHHHYHFQSQGEQLPVISGGTCEVIAAHRCCNRNRIEERSQTVKCSCLPGKVAGTTKAKPSCVDASIVTGKWWCEMEPCLDGEECKTLPDNSGWMCAQGNRVKTTKIHPRY	------------------------HLHLSPQWHHHYHFQSQGEQLPVISGGTCEVIAAHRCCNRNRIEERSQTVKCSCLPGKVAGTTKAKPSCVDASIVTGKWWCEMEPCLDGEECKTLPDNSGWMCAQGNRVKTTKIHPRY	0.86
XP_030048305.1 serum amyloid A-5 protein-like [Microcaecilia unicolor]	MKLSFCILLLSMALCVNAQWYRDVGRQVTDAGRFVKEAAQGTWDMGRAYMDMREANYRNSDKYFHARGNYDAAQRGAGGKWAAETISNAREFFQGGSSGRGVEDSRADQEANRWGREGGDPNHYRPAGLPEKY	------------------QWYRDVGRQVTDAGRFVKEAAQGTWDMGRAYMDMREANYRNSDKYFHARGNYDAAQRGAGGKWAAETISNAREFFQGGSSGRGVEDSRADQEANRWGREGGDPNHYRPAGLPEKY	0.83
XP_030048332.1 serine protease inhibitor Kazal-type 2 [Microcaecilia unicolor]	MNSRTLAPDGKYHSGVPPSMKQLLLCTLFILTTGIIFVPKTEGYLTPNCERYPLPGCPRNLNPVCGTDGETYSNECMLCYSNRSNRRNVKIVTYGYC	-------------------------------------V----GYLTPNCERYPLPGCPRNLNPVCGTD-ETYSNECMLCYSNRSNRRNVKIVTYGYC	0.74
XP_030048333.1 serine protease inhibitor Kazal-type 2 [Microcaecilia unicolor]	MNSRTLAPDGKYHSGVPPSMKQLLLCTLFILTTGIIFVPKTEGYLTPNCERYPLPGCPRNLNPVCGTDGETYSNECMLCYSNRSNRRNVKIVTYGYC	----------------------------------IIFVPKTEGYLTPNCERYPLPGCPRNLNPVCGTDGETYSNECMLCYSNRSNRRNVKIVTYGYC	0.82
XP_030048346.1 liver-expressed antimicrobial peptide 2-like [Microcaecilia unicolor]	MRKEFTQVFAVACVFLLISFSLGNAAPVPNKQGNYLTLRVKRSMLWRWITLRPVGATCTGNAECSTTYCRDGHCSLQVFSS	--------------------------------GNYLTLRV--SMLWRWITLRPVGATCTGNAECSTTYCRDGHCSLQVFSS	0.91
XP_030048356.1 C-X-C motif chemokine 3-like [Microcaecilia unicolor]	MTIQMSLHVLLLLVLLGSWTAPSQGASLRTELRCQCIKTVSEFIPVKQIANVDLTPEGPHCPTVEVIATLKNGFLACLNPEEKWVKRIIHTILNRQSHKL	-----------------------QGASLRTELRCQCIKTVSEFIPVKQIANVDLTPEGPHCPTVEVIATLKNGFLACLNPEEKWVKRIIHTILNRQSHKL	0.9
XP_030048357.1 permeability factor 2-like [Microcaecilia unicolor]	MKSPLSLHLVLLLVLSAGWTTPSQGASLRTELRCQCIKTISEFIPVKQIANVELIPEGPHCPTVEVIATLKSGMQVCLNPDAKWVQIIINKILNGASSRR	---------------------PSQGASLRTELRCQCIKTISEFIPVKQIANVELIPEGPHCPTVEVIATLKSGMQVCLNPDAKWVQIIINKILNGASSR-	0.91
XP_030048361.1 C-X-C motif chemokine 11-1-like [Microcaecilia unicolor]	MGKFATLFLVISLCVTLAEGLSIVGHSQRCLCDGKLYNLIPSRNIRKVEMFPQTPRCYNVEIVITMKTGKRWCLNPKAQRVRAVLGKFSMKRDFKHNY	-----------------------VGHSQRCLCDGKLYNLIPSRNIRKVEMFPQTPRCYNVEIVITMKTGKRWCLNPKAQRVRAVLGKFSMKRDFKHNY	0.89
XP_030048362.1 C-X-C motif chemokine 11-1-like [Microcaecilia unicolor]	MDLRCTVPLCLLLLFTIEIQGSPVAGRGRCLCKETGSNFVRRIYIEKLEVYPQSASCEHREVIVTIKQSGEKRCLNPNSEWVRRILTSFTKKA	-----------------------VAGRGRCLCKETGSNFVRRIYIE--------------------------RCLNPNSEWVRRILTSFTKKA	0.81
XP_030048363.1 C-X-C motif chemokine 10-like [Microcaecilia unicolor]	MEQRLVSLLCLLLLITAGIEGLSIGGKGRCLCIRNGSNFVKQKSIAKIELLPKSSSCEHTEIIITMKQSGKKRCLNPYSKMGKKILARSMKKRFLKISLKKRGK	----------------------SIGGKGRCLCIRNGSNFVKQKSIAKIELLPK-S-------IITMKQSGKKRCLNPYSKMGKKILARSMKKRFLKISLKKRG-	0.8
XP_030048372.1 histone H2A.Z isoform X1 [Microcaecilia unicolor]	MGSTAGSQFKAGGKAGKDSGKTKTKAVSRSQRAGLQFPVGRIHRHLKSRTTSHGRVGATAAVYSAAILEYLTAEVLELAGNASKDLKVKRITPRHLQLAIRGDEELDSLIKATIAGGGVIPHIHKSLIGKKGQQKTV	---------KAGGKAGKDSGKTKTKAVSRSQR-GLQF------------------------------------------------LK---ITPRHLQ-A-R-----DSLIK-TIAGGGVIPHIHKSLIGKKGQQKTV	0.69
XP_030048373.1 histone H2A.Z isoform X2 [Microcaecilia unicolor]	MAGGKAGKDSGKTKTKAVSRSQRAGLQFPVGRIHRHLKSRTTSHGRVGATAAVYSAAILEYLTAEVLELAGNASKDLKVKRITPRHLQLAIRGDEELDSLIKATIAGGGVIPHIHKSLIGKKGQQKTV	---------S-KT-----------G--F---------------------------------------------------------------------DSLIK-TIAGGGVIPHIHKSLIGKKGQQKTV	0.77
XP_030048420.1 mesotocin-neurophysin MT-like [Microcaecilia unicolor]	MMYSTLAVYMFCLLALSSACYIQNCPIGGKRSVLDVMDVRKCIPCGPRNKGHCFGPSICCGEEIGCYFGTPETLRCQEENYLPSPCESGRKPCGNSGGNCAASGICCNNESCIADSTCDQDSAFS	---------------------------------------RKCIPCGPRNKGHCFGP---------------------------S-C-SGRKPCGNSGGNCAASGICCNNESCIADSTCDQ---FS	0.68
XP_030048536.1 apelin receptor early endogenous ligand [Microcaecilia unicolor]	MRLQHLFSILWVILMSLLLISAQRTVNLGQRRKLHRHNCLQRRCLPLHSRVPFP	-----------------------------QRRKLHRHNCLQRRCLPLHSRVPFP	0.92
XP_030048537.1 apelin receptor early endogenous ligand [Microcaecilia unicolor]	MRLQHLFSILWVILMSLLLISAQRTVNLGQRRKLHRHNCLQRRCLPLHSRVPFP	-----------------------------QRRKLHRHNCLQRRCLPLHSRVPFP	0.92
XP_030048541.1 WAP four-disulfide core domain protein 5-like isoform X1 [Microcaecilia unicolor]	MKTSVIILTFAFLLVWVDLDSVSAQQKGDNRGNSSHITTAALISEFQDRPGFCPSNDLPASAIKDAKCTYDKDCIKPTKCCPRGATFDCLPAVKEKPGKCPTTAEKCEEHSKCESDSDCSEDRKCCNLCDKRCLKPVPVKKL	---------------------------------------------F---PGFCPSNDLPASAIKDAKCTYDKDCIKPTKCCPRGATFDCLPAVKEKPGKCPTTAEKCE-HSKCESDSDCSEDRKCCNLCDKRCLKPVPVKKL	0.79
XP_030048542.1 WAP four-disulfide core domain protein 5-like isoform X2 [Microcaecilia unicolor]	MKTSVIILTFAFLLVWVDLDSVSAQQKGDNRGNSSHITTAALINRPGFCPSNDLPASAIKDAKCTYDKDCIKPTKCCPRGATFDCLPAVKEKPGKCPTTAEKCEEHSKCESDSDCSEDRKCCNLCDKRCLKPVPVKKL	-------------------------------GNSSHITTAALINRPGFCPSNDLPASAIKDAKCTYDKDCIKPTKCCPRGATFDCLPAVKEKPGKCPTTAEKCE-HSKCESDSDCSEDRKCCNLCDKRCLKPVPVKKL	0.82
XP_030048543.1 WAP four-disulfide core domain protein 5-like isoform X3 [Microcaecilia unicolor]	MKTSVIILTFAFLLVWVDLDSVSAQQKDRPGFCPSNDLPASAIKDAKCTYDKDCIKPTKCCPRGATFDCLPAVKEKPGKCPTTAEKCEEHSKCESDSDCSEDRKCCNLCDKRCLKPVPVKKL	-----------------------------PGFCPSNDLPASAIKDAKCTYDKDCIKPTKCCPRGATFDCLPAVKEKPGKCPTTAEKCEEHSKCESDSDCSEDRKCCNLCDKRCLKPVPVKKL	0.83
XP_030048776.1 immediate early response 3-interacting protein 1 [Microcaecilia unicolor]	MAFTLYSLIQAALLCVNAIAVLHEERFLSKIGWGADQGIGGFGEEPGVKSQLMNLIRSVRTVMRVPLIVVNSVTIVLLLLFG	--------------------------FLSKIGWGADQGIGGFGEEPGVKS-LM-----------------------------	0.67
XP_030048777.1 immediate early response 3-interacting protein 1 [Microcaecilia unicolor]	MAFTLYSLIQAALLCVNAIAVLHEERFLSKIGWGADQGIGGFGEEPGVKSQLMNLIRSVRTVMRVPLIVVNSVTIVLLLLFG	--------------------------FLSKIGWGADQGIGGFGEEPGVKS-LM-----------------------------	0.67
XP_030048837.1 ubiquitin-40S ribosomal protein S27a [Microcaecilia unicolor]	MQIFVKTLTGKTITLEVECSDTIENVKAKIQDKEGIPPDQQRLIFAGKQLEDGRTLSDYNIQKESTLHLVLRLRGGAKKRKKKSYTTPKKNKHKRKKVKLAVLKYYKVDENGKIHRLRRECPAEECGAGVFMASHFDRHYCGKCCLTYCFNKPEDK	--------------------------------------------------------------------------------KKKSYTTPKKNKHKRKKVKLA-L---------KIHRLRRECPAEECGAGVFMASHFDRHYCGKCCLTYCFNKPED-	0.68
XP_030048859.1 phorbol-12-myristate-13-acetate-induced protein 1 [Microcaecilia unicolor]	MRSRRLLLLLLLFSIFIALESVRSAAQTPSLPTGGNGTMKGRLSHRARSMPAGDGRKRDRQEAVAECASQLRKIGDRCDLKQKIINLISKLLCPET	----------------------------------------------------------------AECASQLRKIGDRCDLKQKIINLISKLLCPE-	0.77
XP_030048960.1 C-C motif chemokine 28 [Microcaecilia unicolor]	MDMKVIAVLIFLHMMQLSEPLTGSSSSCCTEVANHVSKKLLRRVLRFEMQRAVGICPLPAIVLYTRHKKLCANPKIQLIKKWRKKNDKNRGKGNSHRGEKRTNKNKNKIKNRRAWKRQ	------------------------SSSCCTEVANHVSKKLLRRVLRFEMQRAVGICPLPAIVLYTRHKKLCANPKIQLIKKWRKKNDKNRGKGNSHRGEKRTNKNKNKIKNRRAWK--	0.92
XP_030049764.1 lysozyme C-like isoform X1 [Microcaecilia unicolor]	MKPIAIAFLLGLLVLKSEARVFSKCELASALKRGGMAGYHGITLANWMCLVHHESGYNTTAVNDNGPSRDYGIFQINSYLWCNDGQTLGSKNECGINCSSLLNIDIGDDIACAKTVVRKPQGINAWASWRTDCKGRNLSSFVSGCTV	--------------------VFSKCELASALKRGGMAGYHGITLANWMCLVHHESGYNTTAVNDNGPSRDYGIFQINSYLWCNDGQTLGSKNECGINCSSLLNIDIGDDIACAKTVVRKPQGINAWASWRTDCKGRNLSSFVSGCTV	0.94
XP_030049766.1 lysozyme C-like isoform X2 [Microcaecilia unicolor]	MRAQGMCLVHHESGYNTTAVNDNGPSRDYGIFQINSYLWCNDGQTLGSKNECGINCSSLLNIDIGDDIACAKTVVRKPQGINAWASWRTDCKGRNLSSFVSGCTV	----GMCLVHHESGYNTTAVNDNGPSRDYGIFQINSYLWCNDGQTLGSKNECGINCSSLLNIDIGDDIACAKTVVRKPQGINAWASWRTDCKGRNLSSFVSGCTV	0.88
XP_030049767.1 lysozyme C-1-like [Microcaecilia unicolor]	MKPIAIAFLLGLLVLKSEARVYSKCELASALKRGGMAGYHGITLANWMCLAYYESGYNTAAVNNNGPSRDYGIFQINSYWWCNDGKTRGSKNACGISCSSLLNNDISNDIACAKRVVRDPQGINAWVAWRNHCKGRDLSRFVSGCKL	--------------------VYSKCELASALKRGGMAGYHGITLANWMCLAYYESGYNTAAVNNNGPSRDYGIFQINSYWWCNDGKTRGSKNACGISCSSLLNNDISNDIACAKRVVRDPQGINAWVAWRNHCKGRDLSRFVSGCKL	0.93
XP_030050102.1 protein FAM3A isoform X1 [Microcaecilia unicolor]	MRLAGSVRIVVIVLTVGLTWILASVMLGSQGGLPRIQQLLNSPDNAPTADSRPKKYKCGLPQPCPDKHFAFRIVSGAANVIGPKICLEDKMLMSSVKNNVGRGLNIALVNGVNGELIDAKFFDMWAGDVNELLKFVRAVYEGTVVFVASYDDPATKMNDEARKIFSDFGSSAIKDIGFRDSWVFVGAKGVQDKSPFEQHMKNNKNSNKYEGWPEALEMEGCIPQRTAETV	------------------------------GGLPRIQQLLNSP-------SRPKKYKCGLPQPCPDKHFAFRIVSGAANVIGPK------------------------------------------------------------------------------KIFSDFGSSAIKDIGFRDSWVFVGAKGVQDKSPFEQHMK---------GW------E-CIPQ------	0.65
XP_030050103.1 protein FAM3A isoform X1 [Microcaecilia unicolor]	MRLAGSVRIVVIVLTVGLTWILASVMLGSQGGLPRIQQLLNSPDNAPTADSRPKKYKCGLPQPCPDKHFAFRIVSGAANVIGPKICLEDKMLMSSVKNNVGRGLNIALVNGVNGELIDAKFFDMWAGDVNELLKFVRAVYEGTVVFVASYDDPATKMNDEARKIFSDFGSSAIKDIGFRDSWVFVGAKGVQDKSPFEQHMKNNKNSNKYEGWPEALEMEGCIPQRTAETV	------------------------------GGLPRIQQLLNSP-------SRPKKYKCGLPQPCPDKHFAFRIVSGAANVIGPK------------------------------------------------------------------------------KIFSDFGSSAIKDIGFRDSWVFVGAKGVQDKSPFEQHMK---------GW------E-CIPQ------	0.65
XP_030050590.1 uncharacterized protein LOC115464341 [Microcaecilia unicolor]	MRGSIYRPHHNSSKYNHLHHSFYSHNLCFIHFHKLWNNNKYCHNHWHWGQHTPLALGQPQHRNWNNYNHRHWDNYTTGTGTTTTTGTGTTTTTGTGTTTTTGTGTTTGTGTTTTSTGTTTTGTGTTVTGTTGTGSTTNLSGSSTTGGAAAESGLAVWAIILICLASILAFVLLLCICFCVLRGRCGGESHWNSSFPNTSLSRDDCRNPSAPTYTSDCGRMSGMTLDEMGGSSRPAHCRGGSISRSTCNGF	----------------------------------------------------------------------------------------------------------------------------------------------------------------------------------------C-------------------------------------------GGSSRPAHCRGGSISRSTCNGF	0.84
XP_030050599.1 low affinity immunoglobulin epsilon Fc receptor-like [Microcaecilia unicolor]	MIKWYLDLAEVKQKDLSRIDKSLEELKETVGSICQACASRSICQECPLGWLLFRGSCYKFSTTAKDWEGARISCAESNSHLAIINSLEEQYFLSNSTNSKDSWIGLSDKDTEGVWQWVDGSPLSFSFWNTDEPNNYGEGRGLCAASI	-------------------------------------ASRSICQECPLGWLLFRGSCYKFSTTAKDWEGARISCA--------------------------SWIGLSDKDTEGVWQWVDGSPLSFSFWNTDEPNNYGEGRGLCAASI	0.67
XP_030050656.1 cystatin-like [Microcaecilia unicolor]	MFSIWKISLLFMVTLALKAETIIKGKAPSQLGGWTDVNLNENDTELQKALAVAIREHNKASNDQFISVVSNVIQARKQIVAGVRYALTAQIAQTACRKSDSAPENCTKSELSTLSQHKTCTFFVVLAPWQNKEELQQNSCA	---------------------------PSQLGGWTDVN----------------------S-DQFISVVSNVIQARKQIVAGVRYALTAQIAQTACRKSDSAP-N-T------------CTF---LAPWQ-----QQNSC-	0.62
XP_030051125.1 relaxin-3 [Microcaecilia unicolor]	MQQKSIYTKFPDGFSSPAVTDSGEENTGNWKSGLPDSGNQLSWREYLAGSSKQTGNVGLAEDVLDTLFHSERRGRDVILGLASTCCKWGCSKSEISSLC	--------------------------------------------------------------------------RDVILGLASTCCKWGCSKSEISSLC	0.86
XP_030051180.1 epidermal growth factor-like protein 8 isoform X2 [Microcaecilia unicolor]	MALLQLVATALTCLLSTGVRGQVLKEGRGVCSKQTLRVPLIYNETFIQPVYHPFLTTCKGLRTCSTYRTTYRVSYRQVTKEVLQTSITCCPGWQKNHPGATSCDQALCHKPCRNGGICSRPNVCLCRPGWGGKYCQIDVDECRTPIHSCFQQCVNTLGSYHCACHPGFSLGADEKSCQEQPTPSPALPTSEAGMDSEHFPEPSPYAARGYQGRTHTGALDTPPAAGPGGVTE	----------------------V-KEGRGVCSKQT-RV--------------------K-LRT-------------------------------------------LCHKPCRNGGICSRPNVCLCRPGWGGKYCQIDV--CRTPIHSCFQQCVNTLGSYHCACHPGFS---------------------------------S-YAARGYQGRTHTGALDTPP-AGPGGVT-	0.58
XP_030051184.1 epidermal growth factor-like protein 8 isoform X3 [Microcaecilia unicolor]	MALLQLVATTLTCLLSTNLGVRGQVLKEGRGVCSKQTLRVPLIYNETFIQPVYHPFLTTCKGLRTCSTYRTTYRVSYRQVTKEVLQTSITCCPGWQKNHPGATSCDQALCHKPCRNGGICTRPNVCLCRPGWGGKYCQIDVDECRTPIHSCFQQCVNTLGSYHCACHPGFSLGADEKSCQEQPTPSPALPTSEAGMDSEHFPEPSPYAARGYQGRTHTGALDTPPAAGPGGVTE	-----------------------QVLKEGRGVCSKQTLRVPLI-----------PFLTTCKGLRTCSTYRTTY-------------TSITCCPGWQKNHPGATSCDQALCHKPCRNGGICTRPNVCLCRPGWGGKYCQIDVDECRTPIHSCFQQCVNTLGSYHCACHPGFSLGA---------------------------PEPSPYAARGYQGRTHTGALDTPP-AGPGGVT-	0.62
XP_030051213.1 long neurotoxin 1-like [Microcaecilia unicolor]	MKTFIIAAFLAILCISLGDGLKCYHCDLCIDLTIQNHTATCSDNQKCVTSKANNGTLVKRGCLDSNKCETRETITLSDYYHSCCNTDHCNSGHLLQLSLLVCLAVAGLWLLTLT	-------------------GLKCYHCDLCIDLTIQNHTATCSDNQKCVTSKANNGTLVKRGCLDSNKCETRETITLSDYYHSCCNTDHCNSGHL-------------LWL----	0.71
XP_030051276.1 NADH dehydrogenase [ubiquinone] 1 alpha subcomplex subunit 3-like [Microcaecilia unicolor]	MASRIGGFLKKLWAEQPVITVAIAIGIVAVVTPLVSPYTKYSSMMNKAVPYTYPVPLRDDGNMPDVPSHPCDKLGPNLDWLKNL	---RIGGFLKKLWAEQPVITVAIAIGIVAVVTPLVSPYTKYSSMMNKAVPYTYPVPLRDDGNMPDVPSHPCDKLGPNLDWLKNL	0.86
XP_030051398.1 dolichyl-diphosphooligosaccharide--protein glycosyltransferase subunit 4 [Microcaecilia unicolor]	MITDVQLAIFANMLGVSLFLLVVLYHYVAVNNPKKQD	----------------------------------K--	0.51
XP_030051399.1 dolichyl-diphosphooligosaccharide--protein glycosyltransferase subunit 4 [Microcaecilia unicolor]	MITDVQLAIFANMLGVSLFLLVVLYHYVAVNNPKKQD	----------------------------------K--	0.51
XP_030051416.1 prepronociceptin [Microcaecilia unicolor]	MKTLLWTLVLLCLFANVLSDCQRDCLICKKHLYQQDDFNTLVCIVECEGEAYSSVIWKMCKKVLKKTAVQLSVDSMEDNTYNPLETEDGLFRSNLKHLEDLTKVVDLSKIENEKRISKISGLIQEQEEDNTIERSETPLHMTSEPDAFSDLQGQSRDITKRYGGFLKGKYSYRKFLEPARGMQKRYGGFIGVRKSARKWNNQKRFSEFLKQYLGMSTRSSGYDSLSADINEENEI	--------------------CQRDCLIC-----------------------YSSVIWKMC------------------------------------------------------------------------------------------------------G-FLKGKYSYRKFLEP-RGMQ-RYGGFIGVRKSARKWNNQKRFSEFLKQYL----------------------	0.63
XP_030051579.1 histone H3.3 [Microcaecilia unicolor]	MARTKQTARKSTGGKAPRKQLATKAARKSAPSTGGVKKPHRYRPGTVALREIRRYQKSTELLIRKLPFQRLVREIAQDFKTDLRFQSAAIGALQEASEAYLVGLFEDTNLCAIHAKRVTIMPKDIQLARRIRGERA	----------S---KAPRKQLATKAARKSAPSTGGVKKPHRYRPGTV-L----RY--STELLIRKLPFQRLVREI-QDFKTDLRFQS-AIGALQ------L-GLFEDTNLCAIHAKRVTIMPKDIQLARRIRGERA	0.64
XP_030051580.1 histone H3.3 [Microcaecilia unicolor]	MARTKQTARKSTGGKAPRKQLATKAARKSAPSTGGVKKPHRYRPGTVALREIRRYQKSTELLIRKLPFQRLVREIAQDFKTDLRFQSAAIGALQEASEAYLVGLFEDTNLCAIHAKRVTIMPKDIQLARRIRGERA	--------RKSTGGKAPRKQLATKAARKSAPSTGGVKKPHRYRPGTVALREIRRYQKSTELLIRKLPFQRLVREIAQDFKTDLRFQSAAIGALQE-S---L-GLFEDTNLCAIHAKRVTIMPKDIQLARRIRGERA	0.74
XP_030051926.1 retinoic acid receptor responder protein 2-like [Microcaecilia unicolor]	MLKALFLAVCLTWVTSYVPGTATQIELHGIHELKDKTVALAVANFNQRSSIHAYKELDTLNTTATATVTGTFVKVTFTIKETNCNKLGYQPDRCQHKGNGRVFYCVACFAYRAMEEESAAEFTDCVPRHPPTKGRANQQQQRCETVKRAIPDRYRPGEISIMAGLPSLDHNKGILREDVLNAS	-----------------V--TATQIELHGIHE-K-KTVAL---N----------------------------------------NKLGYQPDRCQHKGNGRVFYCVACFAY-----------TDCVPRHPPTKGRANQQQQRCETVKRAIPDRYRPGEISIMAGLPS----------------	0.62
XP_030052127.1 cystatin-like [Microcaecilia unicolor]	MFSVWKISLLFMASLALTAATIPGKKDRRPLGGWTDVNVTENDSGLQKALEVAIREHNKASNDQFINVVTNVIRARRQIVAGMKYSLNVQIAKTDCRKSDSTPENCTESELSRLSQHKRCRFVVYLVPWLKKEELKQNNCD	-----------------------------------------------------------------------------Q----------------------------------RLS-HKRCRFVVYLVPWLKKEELKQNNC-	0.76
XP_030052871.1 cathelicidin-1-like [Microcaecilia unicolor]	MMLWAAVLILVAGSAVAAPFSETRPVPKEVARAAVEVYNQQNEQAAAFKLLKLVLVKKKNFDWGIHFSINFTVKETYCQKTAAYNLQNCKFRENGLVKDCFAEATVLDFVQDLPLTSVECHQHNVTRQRARGAPNTRNQRVKVQPQAMSDDPKVTVRHFHSSFTIAAQSANV	---------------------------------------------------------------------------------A-YNLQN-KFR---LVK----------------------HQ-NVTRQRARGAPNTRNQRVKVQ---M-D----T---FHSSFT------N-	0.56
XP_030052967.1 coiled-coil-helix-coiled-coil-helix domain-containing protein 5 [Microcaecilia unicolor]	MQAALEVTARYCRKEMEAYGECVASKPSSWQKDCQPLKVSVARCTSSHPIIQRIRQECAGPFAAFEGCLRQNQTSAENCAEHMGHFLQCAEKVKPNY	---------RYCRKEMEAYGECVASKPSSWQKDCQPLKVSVARCTSSHPIIQRIRQECAGPFAAFEGCLRQNQTSAENCAEHMGHFLQCAEKVKPNY	0.89
XP_030052968.1 coiled-coil-helix-coiled-coil-helix domain-containing protein 5 [Microcaecilia unicolor]	MQAALEVTARYCRKEMEAYGECVASKPSSWQKDCQPLKVSVARCTSSHPIIQRIRQECAGPFAAFEGCLRQNQTSAENCAEHMGHFLQCAEKVKPNY	---------RYCRKEMEAYGECVASKPSSWQKDCQPLKVSVARCTSSHPIIQRIRQECAGPFAAFEGCLRQNQTSAENCAEHMGHFLQCAEKVKPNY	0.9
XP_030052969.1 coiled-coil-helix-coiled-coil-helix domain-containing protein 5 [Microcaecilia unicolor]	MQAALEVTARYCRKEMEAYGECVASKPSSWQKDCQPLKVSVARCTSSHPIIQRIRQECAGPFAAFEGCLRQNQTSAENCAEHMGHFLQCAEKVKPNY	---------RYCRKEMEAYGECVASKPSSWQKDCQPLKVSVARCTSSHPIIQRIRQECAGPFAAFEGCLRQNQTSAENCAEHMGHFLQCAEKVKPNY	0.89
XP_030053263.1 mucin-1-like [Microcaecilia unicolor]	MARALCTPKAACEILALLLVLSFQTAEAQSAVPGWGIALLVLVAVILLLLLMLCCSMMICRRKDSCESSQSGVSSYFPHLGFSRQDC	-----------------------------------------------------C-SMMICRRKDSCESSQSGVSSYFPHLGFSRQDC	0.77
XP_030053304.1 sperm acrosome membrane-associated protein 4 isoform X2 [Microcaecilia unicolor]	MNKLLLLILVTLLCIHFGEGQVKRCIKCDFTLGDIPCIQSTVTCNTGEVCATIKGKAGSAHLITKRNCVERSRCGVNDTTSWVGVTYTTSTVCCEEDFCNSGVGVIRFSLLAGLTALLCFFLTKIL	---------------------VKRCIKCDFTLGDIPCIQSTVTCNTGEVCATIKGKAGSAHLITKRNCVERSRCGVNDTTSWVGVTYTTSTVCCEEDFCNSGVGVIRFSLLAGLTALLCFFLTKIL	0.78
XP_030053305.1 sperm acrosome membrane-associated protein 4 isoform X3 [Microcaecilia unicolor]	MNKLILWGLVALLCIHFGEGQVKRCIKCDFTLGDIPCIQSTVTCNTGEVCATIKGKAGSAHLITKRNCVERSRCGVNDTTSWVGVTYTTSTVCCEEDFCNSGVGVIRFSLLAGLTALLCFFLTKIL	-----------------------RCIKCDFTLGDIPCIQSTVTCNTGEVCATIKGKAGSAHLITKRNCVERSRCGVNDTTSWVGVTYTTSTVCCEEDFCNSGVGVIRFSLLAGLTALLCFFLTKIL	0.77
XP_030053310.1 protein Bouncer-like [Microcaecilia unicolor]	MKLLLVLMLSAWLCADLGQTQSQNLDCYQCKFRFNSYCMHTISPVISCLRSDNFCGTTKVSIGTNMVYSMTGCILNSECNRTLQEQSPTKFINYNTTCCYGNLCNSSPHLTLSLLSGLGVLVRLLLV	---------------D-GQTQSQNLDCYQCKFRFNSYCMHTISPVISCLRSDNFCGTTKVSIGTNMVYSMTGCILNSECNRTLQE-S-TKFINYNTTCCYGNLCN----------------------	0.73
XP_030053311.1 protein Bouncer-like [Microcaecilia unicolor]	MKLLLVLMLSAWLCADLGQTQSQNLDCYQCKFRFNSYCMHTISPVISCLRSDNFCGTTKVSIGTNMVYSMTGCILNSECNRTLQEQSPTKFINYNTTCCYGNLCNSSPHLTLSLLSGLGVLVRLLLV	------------------QTQSQNLDCYQCKFRFNSYCMHTISPVISCLRSDNFCGTTKVSIGTNMVYSMTGCILNSECNRTLQE-S-TKFINYNTTCCYGNLCN----------------------	0.73
XP_030053312.1 lymphocyte antigen 6 complex locus protein G6c [Microcaecilia unicolor]	MKTFILIGLVTLCFLAVVQGLQCNVCGLKVAIVGCVQSKGTKTCNANEKCQTIKGYIGSAHVFSKLDCSTTDSENCNVTEKSENTFGFTYNKYCCNTDLCNSASALQLPLLAGFSAMIILLLKLS	-------------------------CGLKVAIVGCVQSKGTKTCNANEKCQTIKGYIG-----------------------------FTYNKYCCNTDLCN------------------------	0.6
XP_030053650.1 beta-2-glycoprotein 1-like isoform X2 [Microcaecilia unicolor]	MQRAMGTKIQQLFLALVSFFLVIITGIPKEDAEDTTCPQVREGLAEAMGQTCQKPCLRHRDCSGKRRCLCDGHCGLSCITLSRTCPWPVQLQHADVRLKGESHHFRDEMVVSCHPGFTMSEGGNTVTSHCQGDRKWSSTPACQAELDAENTCGPPPALKNGFHVGFSWKPGNSVQYFCEQSYELDGESVNSCQENLLWSNPAPTCRARCQIPVQRSRIVYQGKKVWIGEVPGGEVQHLEEVTFFCHGQNRSCSYQAISRCFDGHLPLPDCYREPTWLQYTIFPKKLVSEIPSC	--------------------------------------------------------------------------------------------------------------------------------------------------------------------------------------------------------------------VQRSRI------------------------FFCH-QNRSCSYQAISRCFDGHLPLPDCYREPTWLQYTIFPKKLVSEIPSC	0.75
XP_030053749.1 NADH dehydrogenase [ubiquinone] 1 alpha subcomplex subunit 3-like [Microcaecilia unicolor]	MASRIGGFLKKLWAEQPVITVAIAIGIVAVVTPLVSPYTKYSSMMNKAVPYTYPVPLRDDGNMPDVPSHPCDKLGPNLDWLKNL	---RIGGFLKKLWAEQPVITVAIAIGIVAVVTPLVSPYTKYSSMMNKAVPYTYPVPLRDDGNMPDVPSHPCDKLGPNLDWLKNL	0.86
XP_030054230.1 putative lysozyme C-2 [Microcaecilia unicolor]	MKTLALLILLGICALRSEAIGECEVIAEARAASLEGYKGYSLENYACLAFYASNYDTSFQRTPDEFGIVQINRMWCNVGPKDNNPCGIPCSSLLDNDLSDDMKCVKRIVQDPNGLAAWNPWTEYCKDKDLSQFKCLS	------------------------------------------------------------------GIVQINRMWCNVGPKDNNPCGIPCSSLLDNDLSDDMKCVKRIVQDPNGLAAWNPWTEYCKDKDLSQFKCLS	0.8
XP_030054232.1 lysozyme C, milk isozyme-like [Microcaecilia unicolor]	MKTLTLLALLGICILKCEAIGKCEVVEAARWAGLDGYKGYSAANYACLAYYASYYDTSLHNSPTEYGLFQINSYWWCNNSWRDNKACKIRCSSLLDSNIYDDIRCVKRIVQDPNGLDAWTPWVQNCKGRDLRRFNC	-------------ILKCEAIGKCEVVEAARWAGLDGYKGYSAANYACLAYYASYYDTSLHNSPTEYGLFQINSYWWCNNSWRDNKACKIRCSSLLDSNIYDDIRCVKRIVQDPNGLDAWTPWVQNCKGRDLRRFNC	0.86
XP_030054233.1 lysozyme C, milk isozyme-like [Microcaecilia unicolor]	MKTLTLLALLGICILKCEAIGKCEVVEAARWAGLDGVKGYSAANYACLAYYASYYDTSLNNSPTEFGIFQINGDWWCNYNWEENKPCNILCSDLLDSNIYDDILCVKRIVQDPNGLDAWTPWVQNCKGKDLSAFSC	---------------KCEAIGKCEVVEAARWAGLDGVKGYSAANYACLAYYASYYDT-LNNS--EFGIFQINGDWWCNYNWEENKPCNILCSDLLDSNIYDDILCVKRIVQDPNGLDAWTPWVQNCKGKDLSAFSC	0.8
XP_030055387.1 galanin peptides isoform X2 [Microcaecilia unicolor]	MQKAISVFLVSLLLSTNFTYTFGLVLSAKEKRGWTLNSAGYLLGPHAVDNHRSFIEKHGLGGKRELQAEENTKLGNFLKTWMDDNGLHTVIEFLTYLHLKEIGALDNLPSLVSSEEISQS	--------------------------------GWTLNSAGYLLGPHAVDNHRSFIEKHGLGG--EL------------------------------------------------------	0.72
XP_030055388.1 galanin peptides isoform X2 [Microcaecilia unicolor]	MQKAISVFLVSLLLSTNFTYTFGLVLSAKEKRGWTLNSAGYLLGPHAVDNHRSFIEKHGLGGKRELQAEENTKLGNFLKTWMDDNGLHTVIEFLTYLHLKEIGALDNLPSLVSSEEISQS	--------------------------------GWTLNSAGYLLGPHAVDNHRSFIEKHGLGG--EL------------------------------------------------------	0.72
XP_030055401.1 cytochrome c oxidase assembly factor 5 [Microcaecilia unicolor]	MPKYYEDKEEEQTACAGVREDLKTCLLETDCVLKEGKSPKQCLREGHCKALQVTFFECKRSVLDTRSRFRGRKGY	--------------------------------------PKQCLREGHCKALQVTFFECK-SVLDTRSRFRGRKGY	0.72
XP_030055418.1 augurin [Microcaecilia unicolor]	MICSRRSMYSGLALAALVTLLIVCLGPVGSQGNKLRMMLQKQNGAAPAKTEVSVSENKAKEFLGTLNRQKRQLWDRTLPDVQQWYQQFLYLGFDETKFEDDVSYWMSLGRRGNEYYGGYYQHHYDEDAPIGPRNPHTFRHGAGVNYDDY	---------------------------------------------------------------GTLNR---QLWDRTLPDVQQWYQQFLY------------SYWMSLGRRGNEYYGGYYQHHYDEDAPIGPRNPHTFRHGAGVNYDDY	0.69
XP_030056420.1 tissue factor pathway inhibitor 2-like [Microcaecilia unicolor]	MVSASVGALLGASLVLRVLGTLLDNREICLLPSDDGPCNALSFRYYYDRYSQSCEEFAYGGCEGNANNFLTLEDCETTCWMIKKVPKICRQEADTGPCRASIKRYFYNLISKRCEEFIYGGCYGNDNNFDDEASCMDFCDPKKVSPMFCYTPKDEGSCSASVTRYFYNAENKACEEFSYTGCGGNSNNFVTLKDCNNVCKKVRKSRRRPLKIPQKAIA	--------------------------------------------------------------------------C-TTCWMIKKVPKICRQEADTGPCRASIKRYFYNLIS-RC--FI--G-------------CMDFCD--KVSPMFCYTP----SCS-S-TRYF-----KA---FSYTGCGGNSNNFVTLKDCNNVCKKVRKSRRRPLKIPQKAIA	0.71
XP_030056433.1 mitotic-spindle organizing protein 1 [Microcaecilia unicolor]	MASAANLSAVRDTMDVLLEISKLLNTGLDMETLSICVRLCEQGINPEALSSVIKELRKATEALKASENIAS	----------------------------------ICVRLCE-GINPEALSSVIK-----------------	0.6
XP_030056616.1 CD59 glycoprotein-like [Microcaecilia unicolor]	MSGNKWNCVLLSLFFLFLVFCSSGYALKCLVCTSTTQVCTTNHTCPKGDYSCLRITVGTSKTYRCEQHNNCKVEILQKEFGNSFSFYCCQGNDLCNTAIAIPAHKTLLGLLTLIAVVWLVCF	---------------------------KCLVCTSTTQVCTTNHTCPKGDYSCLRITVGTSKTYRCEQHNNCKVEILQKEFGNSFSFYCCQGNDLCNTAIAIPAHKTLL----LIAVVWLVCF	0.71
XP_030056718.1 midkine isoform X1 [Microcaecilia unicolor]	MQLRGIIFILLLALIAISSAARNKKEKGKKGASDCAEWQWGPCTPNSKDCGVGFREGTCKEETVRLKCKIPCNWKKEFGADCKYKFESWGGCDAATGMKARSGTLKKSLYNAECQETIQVTKPCSPKTKSKPKAAKKGKGKE	-----------------------KKEKGKKGASDCAEWQWGPCTPNSKDCGVGFREGTCKEETVRLKCKIPCNWKKEFGADCKYKFESWGGCDAATGMKARSGTLKKSLYNAECQETIQVTKPCSPKTKSKPKAAKKGKGK-	0.89
XP_030056720.1 midkine isoform X2 [Microcaecilia unicolor]	MQLRGIIFILLLALIAISSAARNKKEKGKKGASDCAEWQWGPCTPNSKDCGVGFREGTCKEETVRLKCKIPCNWKKEFGADCKYKFESWGGCDAATGMKARSGTLKKSLYNAECQETIQVTKPCSPKTKSKPKAKKGKGKE	-----------------------KKEKGKKGASDCAEWQWGPCTPNSKDCGVGFREGTCKEETVRLKCKIPCNWKKEFGADCKYKFESWGGCDAATGMKARSGTLKKSLYNAECQETIQVTKPCSPKTKSKPKAKKGKGK-	0.89
XP_030057031.1 protein canopy homolog 1-like [Microcaecilia unicolor]	MNDYNLHVDPETQEKSYKRFAPRDGEQIGAIDFNNFQFNADTSNYLKFVCESVVEKHEDEILSLIAQEADSLAGKLCSEKTGFCQVSSHSEL	---------------------PRD--QIGAIDFNNFQF-AD---Y-K-------------------------AGKLCSEKTGFCQVSSHSE-	0.64
XP_030057451.1 thymosin beta-4 [Microcaecilia unicolor]	MSDKPDMAEIEKFDKAKLKKTETQEKNPLPSKETIEQEKQASE	-------------DKAKLKK-----------------------	0.56
XP_030057535.1 histone H2A.V [Microcaecilia unicolor]	MAGGKAGKDSGKAKAKAVSRSQRAGLQFPVGRIHRHLKTRTTSHGRVGATAAVYSAAILEYLTAEVLELAGNASKDLKVKRITPRHLQLAIRGDEELDSLIKATIAGGGVIPHIHKSLIGKKGQQKTA	-----AGKDSGKAKAKA---SQRAGLQF------------------------------------------------LK---ITPRHLQ-AIR-----DSLIK-TIAGGGVIPHIHKSLIGKKGQQKTA	0.68
XP_030057543.1 vesicle-associated membrane protein 5 [Microcaecilia unicolor]	MSTNLEHCQKEADEVTVIMLNNVTNVIERDGKLKDLEVRSDKLLDMSMNFAKTAVNVERKTRWKTTKCKIIVISAIVVVVLLVLIITILIIYL	---------------------------------------------------------------KTTKCKIIV---------------------	0.56
XP_030057702.1 major prion protein [Microcaecilia unicolor]	MAKSLLTWGIVVLLFLTWIDISQPLKIKTGKSKSGSKKPTSNWGSWGNPNSGTGNTGGTWGNRNPSYPGSNWNNWGQNYNPYGGGSSYNKQWKPHNKAKPNMKMMAGAAVAGAVAGGIGGYALGNAVGRSRIFFDDDYQRYYYNQHPNQFPDRVYRPQYNTNQRVTEDIFVNDCFNYSMTEYVVKPSVEKNVNETDAMETQVMQHVIRQLCIREYQMASGAKILTPPSLVLCVLLFISLVTQ	-------------------------------SKSGSKKPTSNWGSWGNPNSGTGNTGGTWGNRNPSYPGSNWNNWGQNYNPYGGGSSYNKQWKPHNKAKPNMKMMAGAAVAGAVAGGIGGYALGNAVGRSRIFFDDDYQRYYYNQHPNQFPDRVYRPQYNTNQRVTEDIFVNDCFNYSMTEYVVK-----------------------QLCIREYQMASGAK--------------------	0.75
XP_030057718.1 gastrokine-1-like [Microcaecilia unicolor]	MKTLIVIAALLGVFLAPSLGNDNINIVNQDNIGGDDHQTVNIDNHDNIANINNYNGWNSWDSICDYSRGSFAARFFDKKICVVGKINKASFPSLAQLSEVARDKTRSRAPTPMSYSVSPNKVTDVGQFGKHIQALCKDIPTYTSQEAKDGQFSGFALCKSSSIITILGISFCF	-------------------------------------------------NINNYNGWNSWDSICDYSRGSFAARFFDKKICVVGK----------------------------------------GQFGKHIQALCKDIPTYTS---KDGQFSGFALCKSSSIITILGISFCF	0.74
XP_030057983.1 dynein light chain Tctex-type 3-like [Microcaecilia unicolor]	MEEQASNGEADFNAEEASSIVKECVDVILGGLSYDQDKINQWMAAVVEQCLTHLVKLGKMYKYIVSCTVMQKSGAGLHTANSCFWDNATDGSCTVRWENRTMYCVVNVFAIAIPS	---------------------------------Y-Q-KINQWMAAVVEQCLTHLVKLGKMYKYIVSCTVMQKSGAGLHTANSCFWDNATDGSCTVRWENRTMYCVVNVFAIAIPS	0.81
XP_030059034.1 E3 ubiquitin-protein ligase RNF152 [Microcaecilia unicolor]	METLSQDSLLECQICFNYYSPRRRPKLLDCNHTCCSVCLQQMRASHKDLRCPWCRGVTKLPPGFSVSQLPDDPDIVGVVAIPHTSESTPVFIKLPSNGCYMLPLPLSKERALLPGDIGCRLLPGSQQKSVTVVTVPVEQQPLEGGIPQEVGDEEQDRRGVVKSSTWSGVCTVILVACVLVFLLGIVLHNMSCISKRFTVISCG	-------------I-FNYYSPRRRPKLLDCNHTCCSVCLQQMRASHKDLRCP-----------------------------------------------------------------------------------------------------------VV--STWSGVCTVILVACVLVFL-GIVLHNMSCISKRFTVISC-	0.66
XP_030059036.1 stromal cell-derived factor 1 [Microcaecilia unicolor]	MAVKVTALLAFMIVSVVFSEEKPVSLNYRCPCRFVESNTSVSRNSIKHLRIISTPSCSLQIVARLKQNNKQVCLDPKLKWIQEYLEKALSKKSKM	------------------------SLNYRCPCRFVESNTSVSRNSIKHLRIISTPSCSLQIVARLKQNNKQVCLDPKLKWIQEYLEKALSKKSK-	0.88
XP_030059512.1 interferon alpha-inducible protein 27-like protein 2A [Microcaecilia unicolor]	MSDRNVHNAGFTPLGITRGSTASNIMANDAKGHGGGVPSGGATSSLQKMGARSSTHSSGFTSSGIAGGSKASSMMSDQARSHGGGVPKGSTVPTIQSVSMGGKGGKC	----------FTPLGITRGSTASNIMANDAKGHGGGVPSGGATSSLQKMGARSSTHSSGFTSSGIAGGSKASSMMSDQARSHGGGVPKGSTVPTIQSVSMGGKGGKC	0.79
XP_030060762.1 beta-microseminoprotein-like [Microcaecilia unicolor]	MKGFLVVTFAVVFVVIQCNAQCIVEPVQPQSPNKLPEGCVDKKNVIHKIGSSWNTTDCYTCNCLSHDNKVYLSCCGRAIRPSGFDEKHCELIFDQTSCTYSVVEKEDHSKHCSFGGVVVG	--------------------QCIVEPVQPQSPNKLPEGCVDKKNVIHKIGSSWNTTDCYTCNCLSHDNKVYLSCCGRAIRPSGFDEKHCELIFDQTSCTYSVVEKEDHSKHCSFGGVVVG	0.79
XP_030060776.1 C-C motif chemokine 17 [Microcaecilia unicolor]	MNHLQTALLLILLLGTLTQPNMGRNSIECCTEYVRNRIRLTLLKSFYETPSDCPKKAVVFLTARKHICADPSMKWVRKAKVHIKKLQQKQ	-----------------------RNSIECCTEYVRNRIRLTLLKSFYETPSDCPKKAVVFLTARKHICADPSMKWVRKAKVHIKKLQQKQ	0.89
XP_030060799.1 trefoil factor 1-like [Microcaecilia unicolor]	MEYKLLCVLAITLVLGFSSLAEGQAAYMEKQCSQSPKQRENCGQAGISATECYDKGCCFDNSVPETIWCFHPQNECL	------------------------AAYMEKQCSQSPKQRENCGQAGISATECYDKGCCFDNSVPETIWCFHPQNECL	0.82
XP_030060800.1 putative gastrointestinal growth factor xP1 [Microcaecilia unicolor]	MEKKVICVLAIALVLGLSSSAKGQAPFTEAQCQIQPKFRINCGPPSISAQACYDKGCCFDSDKTGVIWCYYPSPEAECVL	-----------------------QAPFTEAQCQIQPKFRINCGPPSISAQACYDKGCCFDSDKTGVIWCYYPSPEAECVL	0.9
XP_030060897.1 histone H4 [Microcaecilia unicolor]	MSGRGKGGKGLGKGGAKRHRKVLRDNIQGITKPAIRRLARRGGVKRISGLIYEETRGVLKVFLENVIRDAVTYTEHAKRKTVTAMDVVYALKRQGRTLYGFGG	---RGKGGKGLGKGGAKRHRKVLRDNIQGITKPAIRRLARRGGVKRISGLIYEETRGVLKVFLENVIRDAVTYTEHAKRKTVTAMDVVYALK-QGRTLYGFG-	0.83
XP_030060998.1 phospholipase A2, minor isoenzyme-like [Microcaecilia unicolor]	MFQLLLVFFLAASAVNAAPSKALWQFRNIIKCTMPNSKPLEEFNRYGCYCGLGGQGNPLDELDTCCQVHDNCYNAAKQVENCSSLIHNPYTEVYAYTCSGTTVTCESDNSPCEMHVCECDRQAALCFSKASYNEDFKDVDKNKHC	------------------P-KALWQFRNIIKCTMPNSKPLEEFNRYGCYCGLGGQGNPLDELDTCCQVHDNCYNAAKQVENCSSLIHNPYTEVYAYTCSGTTVTCESDNSPCEMHVCECDRQAALCFSKASYNEDFKDVDKNKHC	0.87
XP_030061523.1 uncharacterized protein KIAA0040 homolog [Microcaecilia unicolor]	MDHVSTFFKSLWKTVETKHEEGLYNTICLAVLLVLPTVILILALIICCHCCCCRQKTGSANIQSEKKKKKKNAEEDLWISANPKTMMLEKMPSLSA	-------------------------------------------LIICCHCCCCRQKTGSANIQSEKKKKKKNAEEDLWIS----------------	0.75
XP_030061803.1 low-density lipoprotein receptor class A domain-containing protein 1 [Microcaecilia unicolor]	MTRTHPWKSLDEASFTSTVSILSKEKDEVDCCESCSGACCSRRCVCISVIALLLLGVIAAVIACAVILGIPKRSPGTRQCITADNQTGFLCDDAAVCIEASQVCDRIKSCGNGEDEETVMCSDLPNNLPSYLIFRCGDPQNWIFINQKCNGFNNCGDCSDEIGTLSDCSSSCGPRQWSCTSIFHQYCTCIPRSLCRDRTQHCADWSDEFVCPK	-----------------------------------------------------------------------------RQC----------------------------------------------------IFRCGDPQNWIFINQKCNGFNNCGDCSDEIGTLSDCSSSCGPRQWSCTSIFHQYCTCIPRSLCRDRTQHCADWSDEFVCPK	0.79
XP_030061934.1 WAP four-disulfide core domain protein 2-like isoform X1 [Microcaecilia unicolor]	MMAAGSISLLLALLVLCTDSYPTTPDAEHPGVCPELREWELGNCAIRCKSDSDCLNYMKCCGTGCDGSLCKLPNDKPGLCPEAIQAESCPSANQCKSDNQCQGTLKCCQSGCSQLSCQSPTAGSKQL	------------------------------GVCPELREWELGNCAIRCKSDSDCLNYMKCCGTGCDGSLCKLPNDKPGLCPEAIQAESCPSANQCKSDNQCQGTLKCCQSGCSQLSCQSPTAGSKQL	0.87
XP_030061935.1 WAP four-disulfide core domain protein 2-like isoform X2 [Microcaecilia unicolor]	MMAAGSISLLLALLVLCTDSYPTTPDAEHPGVCPELREWELGNCAIRCKSDSDCLNYMKCCGTGCDGSLCKLPNDKPGLCPEAIQAESCPSANQCKSDNQCQGTLKCCQSGCSQLSCQSPTGSKQL	------------------------------GVCPELREWELGNCAIRCKSDSDCLNYMKCCGTGCDGSLCKLPNDKPGLCPEAIQAESCPSANQCKSDNQCQGTLKCCQSGCSQLSCQSPTGSKQL	0.87
XP_030062120.1 trypsin inhibitor-like [Microcaecilia unicolor]	MKTMMVLTVGLLLFCVLQSQAEDELLPPEDNRAACTLPIEPGGCKALYIRWAYDSEQGHCVPFNYGGCRGNANNFLTEEECNGLCKIS	--------------------------------AACTLPIEPGGCKALYIRWAYDSEQGHCVPFNYGGCRGNANNFLTEEECNGLCKI-	0.87
XP_030062482.1 histone H2A-like [Microcaecilia unicolor]	MSGRGKTGGKARAKAKSRSSRAGLQFPVGRVHRLLRKGNYAERVGAGAPVYLAAVLEYLTAEILELAGNAARDNKKTRIIPRHLQLAVRNDEELNKLLGGVTIAQGGVLPNIQAVLLPKKTGGSAAPTAHPKGGKKMSQQSQEY	-----KTGGKARAKAKSRSSRAGLQFPVGRVHRLLRKGNYAERVGAGAPVY---------------------D-KKTRIIPRHLQLAVR------KLLGGVTIAQGGVLPNIQAVLLPKKTGGSAAPTAHPKGGKKMSQQ----	0.67
XP_030062484.1 histone H2A-like [Microcaecilia unicolor]	MSGRGKTGGKARAKAKSRSSRAGLQFPVGRVHRLLRKGNYAERVGAGAPVYLAAVLEYLTAEILELAGNAARDNKKTRIIPRHLQLAVRNDEELNKLLGGVTIAQGGVLPNIQAVLLPKKTGGSAAPTAHPKGGKKMSQQSQEY	-----KTGGKARAKAKSRSSRAGLQFPVGRVHRLLRKGNYAERVGAGAPVY---------------------D-KKTRIIPRHLQLAVR------KLLGGVTIAQGGVLPNIQAVLLPKKTGGSAAPTAHPKGGKKMSQQ----	0.66
XP_030062491.1 histone H2A-like [Microcaecilia unicolor]	MSGRGKTGGKARAKAKSRSSRAGLQFPVGRVHRLLRKGNYAERVGAGAPVYLAAVLEYLTAEILELAGNAARDNKKTRIIPRHLQLAVRNDEELNKLLGGVTIAQGGVLPNIQAVLLPKKTGGSAAPTAHPKGGKKMSQQSQEY	-----KTGGKARAKAKSRSSRAGLQFPVGRVHRLLRKGNYAERVG-GA-V-------------------------KTRIIPRHLQ-A-R-------LLGGVTIAQGGVLPNIQAVLLPKKTGGSAAPTAHPKGGKKMSQQ----	0.62
XP_030062494.1 histone H2A-like [Microcaecilia unicolor]	MSGRGKTGGKARAKAKSRSSRAGLQFPVGRVHRLLRKGNYAERVGAGAPVYLAAVLEYLTAEILELAGNAARDNKKTRIIPRHLQLAVRNDEELNKLLGGVTIAQGGVLPNIQAVLLPKKTGGSAAPTAHPKGGKKMSQHSQEY	-----KTGGKARAKAKSRSSRAGLQFPVGRVHRLLRKGNYAERVGAGAPVY---------------------D-KKTRIIPRHLQLAVR------KLLGGVTIAQGGVLPNIQAVLLPKKTGGSAAPTAHPKGGKKMSQHSQE-	0.66
XP_030062575.1 histone H2A type 2-B-like [Microcaecilia unicolor]	MSGRGKSGGKARAKAKSRSSRAGLQFPVGRVHRLLRKGNYAERVGAGAPVYLAAVLEYLSAEILELAGNAARDNKKTRIIPRHLQLAIRNDEELNKLLGGVTIAQGGVLPNIQAVLLPKKTQTKK	-----KSGGKARAKAKSRSSRAGLQFPVGRVHRLLRKGNYAERVGAGAPVY------------------AARDNKKTRIIPRHLQLAIRND----KLLGGVTIAQGGVLPNIQAVLLPKKTQ-KK	0.68
XP_030062695.1 LOW QUALITY PROTEIN: allograft inflammatory factor 1-like [Microcaecilia unicolor]	MTAVHNTQGGKMFGLLKAQQDLRLQEVNQEFLDDEKFNNEDDSEEKLTSFKRKMCFFDLNDEGEIDMMSLKRMMEKLGVPKTHLEVKKMISEVTGGASETICYRDFVKMMLGKRSAVLKL	------------FG-------------------------------------------------------------------------------------TI-YRDFVK------------	0.53
XP_030062805.1 inter-alpha-trypsin inhibitor-like isoform X2 [Microcaecilia unicolor]	MKLMLVLSVGLLLTLLQAHALEESLPEGHRDFCLLEPDPGLCQALMPKYFYNSTSQACERFNYGGCGGNKNNFVSKDQCVESCINKNYCGQDKVVGPCKAKNNRYFYNSTSKACELFVYGGCFGNGNNFFLEEECKQICRTKGSADFWL	--------------------------------C----DPGLCQALMPKYFYNSTSQACERFNYGGCGGNKNNFVSKDQCVESCINKNYCGQDKVVGPCKAKNNRYFYNSTSKACELFVYGGCFGNGNNFFLEEECKQICRTKGSADFWL	0.84
XP_030062919.1 kappaPI-actitoxin-Avd3b-like [Microcaecilia unicolor]	MRLILVLTVGLLLTCVLQAEAQSTTTTTTSWNEWPYWTTTTTTYREICSLPIDWGSCTSTQPRWGYNIYSGRCELFYYQGSYGNENNFLTYEDCKARCC	--------------------------------EWPYWTTTTTTYREICSLPIDWGSCTSTQPRWGYNIYSGRCELFYYQGSYGNENNFLTYEDCKARCC	0.87
XP_030063314.1 protein FAM136A isoform X1 [Microcaecilia unicolor]	MAEEQQRRVEGAVDQMVKGLEREQIRKMQGKMFRCSADCCDNDAASMQQVHNCIERCHAPLAQAQSIVTSELERFQDRLARCTMHCNDKARDSLDGGSKEPQVKLQLQTCITQCVDDHMNLIPSMTRKLKETLIAAAK	-------------------------------MFRCSADCCDNDAASMQQVHNCIERCHAP-------------RFQDRLARCTMHCNDKARDSLDGGSKE---KLQLQTCITQCVDDHMNLI----RKLKETLI-A--	0.61
XP_030063315.1 protein FAM136A isoform X2 [Microcaecilia unicolor]	MFRCSADCCDNDAASMQQVHNCIERCHAPLAQAQSIVTSELERFQDRLARCTMHCNDKARDSLDGGSKEPQVKLQLQTCITQCVDDHMNLIPSMTRKLKETLIAAAK	--RCSADCCDNDAASMQQVHNCIERCHAPLAQAQSIVTSELERFQDRLARCTMHCNDKARDSLDGGSKE---KLQLQTCITQCVDDHMNLI----RKLKETLI-A--	0.68
XP_030063316.1 protein FAM136A isoform X2 [Microcaecilia unicolor]	MFRCSADCCDNDAASMQQVHNCIERCHAPLAQAQSIVTSELERFQDRLARCTMHCNDKARDSLDGGSKEPQVKLQLQTCITQCVDDHMNLIPSMTRKLKETLIAAAK	--RCSADCCDNDAASMQQVHNCIERCHAPLAQAQSIVTSELERFQDRLARCTMHCNDKARDSLDGGSKE---KLQLQTCITQCVDDHMNLI----RKLKETLI-A--	0.68
XP_030063317.1 protein FAM136A isoform X2 [Microcaecilia unicolor]	MFRCSADCCDNDAASMQQVHNCIERCHAPLAQAQSIVTSELERFQDRLARCTMHCNDKARDSLDGGSKEPQVKLQLQTCITQCVDDHMNLIPSMTRKLKETLIAAAK	--RCSADCCDNDAASMQQVHNCIERCHAPLAQAQSIVTSELERFQDRLARCTMHCNDKARDSLDGGSKE---KLQLQTCITQCVDDHMNLI----RKLKETLI-A--	0.68
XP_030063372.1 PDZK1-interacting protein 1 [Microcaecilia unicolor]	MFTIPLYLLCVLITLGSISCQQENVPIQRRFPQWLTGLIAVSVFLFLVLVVFVVNRVWCEDKKKNEPIAVNKKDEVISNGTEGHYAGIDNFRSPDHDNAYENRIEWEEQVVQTTAM	-------------------------P-Q-RFPQWLTGL------------------VWCEDKKKNEPIAVNKK-------------------------------------------	0.69
XP_030063383.1 sushi domain-containing protein 3 isoform X3 [Microcaecilia unicolor]	MQTATASVLDISRTVLIAEDGNHGHNRTAISKYETFGFKVAVIASIVSGAIILLMSMAFLTCCLIKCIKKNERKRTEREMQLWHQLEREELENMQTSYFGLKGRNNNNNKFRNKAVFNEWLSMAYDNQGFCRSQESQIRDITRPMVSRECHSQSKSNNAQTVSDKRAISGCNRIYTVSGTHVVEVYRQDRGAQKKQGSHMPG	----------------------------AISKYETFGFKVAVI-SIVS-AIILLMSMAFLTCCLIKC------------------------------YFGLKGRNNNNNKFRNKAVFNEWLSMAYDNQGFCRSQESQIRDITRPMVSRECHSQSKSNNAQTVSDKRAISGCNRIYTVSGTHVVEVYRQDRGAQKKQGSHMPG	0.7
XP_030063672.1 allograft inflammatory factor 1-like [Microcaecilia unicolor]	MKSSTMKMMRKKNSPLLNRRFLEFDLNDEGEIDMMSLKRMMEKLGVPKTHLEVKKMISEVTGGASETICYRDFVKMMLGKRSAVLKLIMMFEGRANGTSCKPAGPPAKRDISSLP	-----------------------------------------------------------------------D---------------I-MF---ANGTSCKPAGPPAKRDISSLP	0.69
XP_030063799.1 DNA repair protein SWI5 homolog isoform X2 [Microcaecilia unicolor]	MQKSNKSRIGLLIQSQRSSKVGAVSKDTIHQEITDLRERDAALSKETAQLVAEGYSLEELDKHISLLHQYNDLRDTGQLLLGRLALQDVSLLAEWKTF	-------------------------------------------------------------------------------------------L-E-KTF	0.57
XP_030064110.1 histone H3.3 [Microcaecilia unicolor]	MARTKQTARKSTGGKAPRKQLATKAARKSAPSTGGVKKPHRYRPGTVALREIRRYQKSTELLIRKLPFQRLVREIAQDFKTDLRFQSAAIGALQEASEAYLVGLFEDTNLCAIHAKRVTIMPKDIQLARRIRGERA	--------RKSTGGKAPRKQLATKAARKSAPSTGGVKKPHRYRPGTVALREIRRYQKSTELLIRKLPFQRLVREIAQDFKTDLRFQSAAIGALQE-S---L-GLFEDTNLCAIHAKRVTIMPKDIQLARRIRGERA	0.74
XP_030064121.1 small integral membrane protein 5 [Microcaecilia unicolor]	MASQNLSHEVTKIGQKLLNKIQKLPQADHIEIISFAVILLFIFTVLMLAVLACSYCCCDFSKRRRLLRVQPGGEV	------------IGQKLLNKIQKLPQADHIE-----------------AVLACSYCCCDFSKRRRLLRVQPGGEV	0.76
XP_030064575.1 apelin [Microcaecilia unicolor]	MDLRLWTLALLLLFLTLTSVCGGPLAESSDGNVPEEDGIRNLVHPKGVRNGAGHRQGHWRKYRRQRPRLSHKGPMPF	-----------------------------D--------IRNLVHPKGVRNGAGHRQGHWRKYRRQRPRLSHKGPMPF	0.84
XP_030064962.1 tumor necrosis factor receptor superfamily member 12A [Microcaecilia unicolor]	MLLAQGLPLPLLVLLLLGLAGAEQAAESACQNGKSWSSDLGKCMDCFSCKKSPKGDFCQTCDDVIAKKNDPMWLIVGGTATIFVMLCVIIGLVIFFTQCRKREKFTTPIEETGGHSAEESLIH	----------------------------ACQNGKSWSSDLGKCMDCFSCKKSPKGDFCQTCDDVIAKKNDPMWLIVGGTATIFVMLCVIIGLVIFFTQCRKREKFTTP---------------	0.77
XP_030065267.1 thymosin beta-15B [Microcaecilia unicolor]	MSDPKPDMSEVEKFDHRKLKKTSTEEKNTLPSKETIEQEKAACQKS	-----------------KL----------------------ACQK-	0.56
XP_030065268.1 thymosin beta-15B [Microcaecilia unicolor]	MSDPKPDMSEVEKFDHRKLKKTSTEEKNTLPSKETIEQEKAACQKS	-----------------KL----------------------ACQK-	0.56
XP_030065556.1 uncharaterized LOC112694756 homolog [Microcaecilia unicolor]	MAPLTFPPSSTPLHGSISGLMLPLPAIVLLAVTAYLLFLLLVISCQQCLLARGFCTDCCSWGKAGQLGLCDCCLACAESCDCRVPSMTHFLDSCCPRGTTCDPGSCLTSQCCPLCDFACAYQPPDCETINCICFEVRLR	---------------------------------------------QQCLLARGFCTDCCSWGKAGQLGLCDCCLACAESCDCRVPSMTHFLDSCCPRGTTCDPGSCLTSQCCPLCDFACAYQPPDCETINCICFEVRLR	0.92
XP_030065557.1 uncharaterized LOC112694756 homolog [Microcaecilia unicolor]	MAPLTFPPSSTPLHGSISGLMLPLPAIVLLAVTAYLLFLLLVISCQQCLLARGFCTDCCSWGKAGQLGLCDCCLACAESCDCRVPSMTHFLDSCCPRGTTCDPGSCLTSQCCPLCDFACAYQPPDCETINCICFEVRLR	---------------------------------------------QQCLLARGFCTDCCSWGKAGQLGLCDCCLACAESCDCRVPSMTHFLDSCCPRGTTCDPGSCLTSQCCPLCDFACAYQPPDCETINCICFEVRLR	0.92
XP_030065558.1 uncharaterized LOC112694756 homolog [Microcaecilia unicolor]	MAPLTFPPSSTPLHGSISGLMLPLPAIVLLAVTAYLLFLLLVISCQQCLLARGFCTDCCSWGKAGQLGLCDCCLACAESCDCRVPSMTHFLDSCCPRGTTCDPGSCLTSQCCPLCDFACAYQPPDCETINCICFEVRLR	---------------------------------------------QQCLLARGFCTDCCSWGKAGQLGLCDCCLACAESCDCRVPSMTHFLDSCCPRGTTCDPGSCLTSQCCPLCDFACAYQPPDCETINCICFEVRLR	0.92
XP_030065590.1 chymotrypsin inhibitor Ani s 6-like isoform X2 [Microcaecilia unicolor]	MVSGDLGKEEVKLSMMKTSSAAFLFLVLALPLLLVSGMPTSTTALPLLLVSGMPTSTTVQSCPPNMRYNPCGTSCPETCASSTTMCNMMCVAGCVCQEGYVRRCDKNDVCVPKSECYIGMCSNKSPCKPCPPGSMCPAVCLPPDY	------------------------------------------------------------SCPPNMRYNPCGTSCPETCASSTTMCNMMCVAGCVCQEGYVRRCDKNDVCVPKSECYIGMCSNKSPCKPCPPGSMCPAVCLPPDY	0.92
XP_030065591.1 SCO-spondin-like isoform X3 [Microcaecilia unicolor]	MMKTSSAAFLFLVLALPLLLVSGMPTSTTGCIPTDGQGGCRSYGKAEMVQIRDRSLEARGAGAQVASRRNGHGRVGHHDPEENCPPDMYYDSCGTTCPEACDNINLTMICTMMCVPGCFCQDGYVMICTGNDTCVPESECDIEMC	-----------------------------GCIPTDGQGGCRSYGKAEMVQIRDRSLEARGAGAQVASRRNGHGRVGHHDPEENCPPDMYYDSCGTTCPEACDNINLTMICTMMCVPGCFCQDGYVMICTGND-C-P--E------	0.73
XP_030065592.1 SCO-spondin-like isoform X3 [Microcaecilia unicolor]	MMKTSSAAFLFLVLALPLLLVSGMPTSTTGCIPTDGQGGCRSYGKAEMVQIRDRSLEARGAGAQVASRRNGHGRVGHHDPEENCPPDMYYDSCGTTCPEACDNINLTMICTMMCVPGCFCQDGYVMICTGNDTCVPESECDIEMC	-----------------------------GCIPTDGQGGCRSYGKAEMVQIRDRSLEARGAGAQVASRRNGHGRVGHHDPEENCPPDMYYDSCGTTCPEACDNINLTMICTMMCVPGCFCQDGYVMICTGND-C-P--E------	0.74
XP_030065593.1 venom serine protease inhibitor-like isoform X4 [Microcaecilia unicolor]	MMKTSSAAFLFLVLALPLLLVSGMPTSTTVQSCPPNMRYNPCGTSCPETCASSTTMCNMMCVAGCVCQEGYVRRCDKNDVCVPKSECYIGMCSNKSPCKPCPPGSMCPAVCLPPDY	-------------------------------SCPPNMRYNPCGTSCPETCASSTTMCNMMCVAGCVCQEGYVRRCDKNDVCVPKSECYIGMCSNKSPCKPCPPGSMCPAVCLPPDY	0.92
XP_030065804.1 small ubiquitin-related modifier 3 [Microcaecilia unicolor]	MSEEKPKEGVKTENDHINLKVAGQDGSVVQFKIKRHTALNKLMKAYCDRQGLSMRQIRFRFDGQPINETDTPAQLEMEDEDTIDVFQQQTGGVC	-------------------------------K---H-ALNKLMKAY-------------------------------------------TGGVC	0.57
XP_030065941.1 60S ribosomal protein L39 [Microcaecilia unicolor]	MSSHKTFKIKRFLAKKQKQNRPIPQWIRMKTGNKIRYNSKRRHWRRTKLGL	------FKIKRFLAKKQKQNRPIPQWIRMKTGNKIRYNSKRRHWRRTKLG-	0.9
XP_030066134.1 ly6/PLAUR domain-containing protein 6 isoform X1 [Microcaecilia unicolor]	MEPWPGVAWVLLLSFIADLLKTGQSRDFTVKDIINLHPSTTPYPGGFKCFTCERAVDNYECNRWAPDVYCPRETRYCYTQHIMDTRGESISVTKYCVPLERCLSIGCKETKHEGHKICTSCCEGNICNLALPRNATDAVFATTSPVNQTERHLQQIVLILSCLSLLWMTTT	----------------------------------------------FKCFTCERAVDNYECNRWAPDVYCPRETRYCYTQHIMDTRGE-I--TKYCVPLERCLSIGCKETKHEGHKICTSCCEGNICNLALPRN-------------------------------------	0.62
XP_030066135.1 ly6/PLAUR domain-containing protein 6 isoform X2 [Microcaecilia unicolor]	MEPWPGVAWVLLLSFIADLLKTGQSRDFTVKDIINLHPSKTRYCYTQHIMDTRGESISVTKYCVPLERCLSIGCKETKHEGHKICTSCCEGNICNLALPRNATDAVFATTSPVNQTERHLQQIVLILSCLSLLWMTTT	-----------------------------------------RYCYT--IMDTRGE-I--TKYCVPLERCLSIGCKETKHEGHKICTSCCEGNICNLALPRN-T-----------------------------------	0.62
XP_030066138.1 venom serine protease inhibitor-like isoform X2 [Microcaecilia unicolor]	MKTSSPAFLFLVLALPLLLMSGMPPLEAVPSCPPNMRYDSCGKDCPETCDSSTNSPRECSKMCVADCVCKEGYVRKCDKDDVCVPKSECYTKTCPIKILCKPCTAPPGAACLDVCISPDV	------------------------------SCPPNMRYDSCGKDCPETCDSSTNSPRECSKMCVADCVCKEGYVRKCDKDDVCVPKSECYTKTCPIKILCKPCTAPPGAACLDVCISPDV	0.87
XP_030066172.1 NADH dehydrogenase [ubiquinone] 1 alpha subcomplex subunit 1 [Microcaecilia unicolor]	MWFEILPSLTIMTICLIIPGVATTQIHRWTNGGKEKRIARYEYQWYLMERDRRVSGVNLYYKSKGLDNVD	------------------P-VATTQIHRWTNGGKEKRIARYEYQWYLMERDRRVSGVNLYYKSKGLDNVD	0.88
XP_030066655.1 venom serine protease inhibitor-like [Microcaecilia unicolor]	MKTSSPAFLFLVLALPLLLMSGMPPLEAVPSCPPNMRYDSCGKDCPETCDSSTNSPRVCDMMCVVGCVCKEGYVRKCHKDDVCVPKSECYTKTCPIKSRCKPCTAPPGAACPDVCIPPDEIMAA	------------------------------SCPPNMRYDSCGKDCPETCDSSTNSPRVCDMMCVVGCVCKEGYVRKCHKDDVCVPKSECYTKTCPIKSRCKPCTAPPGAACPDVCIPPDEIMAA	0.85
XP_030067229.1 C-X-C motif chemokine 14 [Microcaecilia unicolor]	MRRLIGAALVLLVVICSVSVQGSKCKCSRKGPKIRYTDVQKLEIKPKYPHCQEKMVIVTVQKMSRFRGQQYCLHPKLHSTKRLVKWYTLWKEKWKVYTE	----------------------SKCKCSRKGPKIRYTDVQKLEIKPKYPHCQEKMVIVTVQKMSRFRGQQYCLHPKLHSTKRLVKWYTLWKEKWKVYTE	0.86
XP_030067650.1 FXYD domain-containing ion transport regulator 3 isoform X2 [Microcaecilia unicolor]	MVVPRRIHIMQPVRASFFLALAALPVLKANDPEDKDSPFFYDYHALRVGGLICAAILCVLGIIVLLSGKCRCKFNQKNRNKRRSESQVQQQLITPGSATNC	------------------------------------------------GGLICAAILCVLGIIVLLSGKCRCKFNQKNRNKRRSESQVQQQLITPGSATNC	0.76
XP_030067853.1 neuropeptide W [Microcaecilia unicolor]	MLGHCLGLLLLLQPISAWYKHAASPRYHTVGRASGLLMGIRRSPYLWRRDVALGQPQDLSDGSGALRLWRRLRSAGAQEEALPAGSTEVRPKGLSVAGPRRRLRTEVAGPDGRLRVRAGPCRDPTTRGTLHCD	-----------------------SPRYHTVGRASGLLMGIRRSPY-----------------------------------------------GL-----R-RLRTE-AGPDGRLRVRAGPCRDPTTRGTLHCD	0.7
XP_030067898.1 WAP four-disulfide core domain protein 3-like isoform X1 [Microcaecilia unicolor]	MKAAGGIFLTVVLLSLWAEQQAVSLQQSEVKAGVCPPARNIKKTPFCDSFCTNDKDCSGNKKCCDDGCDKFCKPPAAEKTGTCPAQPQKTSTEGSGDECTSDSECAGTFKCCPGQSGKACTPPSGEAPGFCPPNVLPPGIGATICIVDCNNCSAEEKCCSMGCTRRCMKTSQDKPGSCPYDPVRCIRAARSTCASDSGCPGDQKCCSHMCGMSCLAVSDKPGSCPNDPIKCVRAGPSTCASDSGCPGDQKCCSYMCGMNCLAVSATKQK	--------------------------------GVCPPARNIKKTPFCDSFCTNDKDCSGNKKCCDDGCDKFCKPPAA---G----------------E-TSDSECAGTFKCCPGQSGKACTPPSGEAPGFCPPNVLPPGIGATICIVDCNNCSAEEKCCSMGCTRRCMKTSQDKPGSCPYDPVRCIRAARSTCASDSGCPGDQKCCSHMCGMSCLAVSDKPGSCPNDPIKCVRAGPSTCASDSGCPGDQKCCSYMCGMNCLAVSATKQ-	0.76
XP_030067899.1 perlwapin-like isoform X2 [Microcaecilia unicolor]	MKAAGGIFLTVVLLSLWAEQQAVSLQQSEVKAGVCPPARNIKKTPFCDSFCTNDKDCSGNKKCCDDGCDKFCKPPAAEKTGTCPAQPQKTSTEGSGDECTSDSECAGTFKCCPGQSGKACTPPSGEAPGFCPPNVLPPGIGATICIVDCNNCSAEEKCCSMGCTRRCMKTSQDKPGSCPYDPVRCIRAARSTCASDSGCPGDQKCCSHMCGMSCLAVSATKQK	----------------------------------CPPARNIKKTPFCDSFCT--K----NKKCCDDGCDKFCK--------------------------TS-S--AGTFKCCPGQSGKACTPPSGEAPGFCPPNVLPPGIGATICIVDCNNCSAEEKCCSMGCTRRCMKTSQDKPGSCPYDPVRCIRAARSTCASDSGCPGDQKCCSHMCGMSCLAVSATKQ-	0.71
XP_030067900.1 perlwapin-like isoform X3 [Microcaecilia unicolor]	MKAAGGIFLTVVLLSLWAEQQAVSLQQSEVKAGVCPPARNIKKTPFCDSFCTNDKDCSGNKKCCDDGCDKFCKPPAAEKTGTCPAQPQKTSTEGSGDECTSDSECAGTFKCCPGQSGKACTPPSGEAPGFCPPNVLPPGIGATICIVDCNNCSAEEKCCSMGCTRRCMKTSQDKPGSCPNDPIKCVRAGPSTCASDSGCPGDQKCCSYMCGMNCLAVSATKQK	--------------------------------GVCPPARNIKKTPFCDSFCTNDKDCSGNKKCCDDGCDKFCKPPAAEKTG---------------DECTSDSECAGTFKCCPGQSGKACTPPSGEAPGFCPPNVLPPGIGATICIVDCNNCSAEEKCCSMGCTRRCMKTSQDKPGSCPNDPIKCVRAGPSTCASDSGCPGDQKCCSYMCGMNCLAVSATKQ-	0.79
XP_030067943.1 histone H3.3 [Microcaecilia unicolor]	MARTKQTARKSTGGKAPRKQLATKAARKSAPSTGGVKKPHRYRPGTVALREIRRYQKSTELLIRKLPFQRLVREIAQDFKTDLRFQSAAIGALQEASEAYLVGLFEDTNLCAIHAKRVTIMPKDIQLARRIRGERA	--------RKSTGGKAPRKQLATKAARKSAPSTGGVKKPHRYRPGTVALREIRRYQKSTELLIRKLPFQRLVREIAQDFKTDLRFQSAAIGALQE-S---L-GLFEDTNLCAIHAKRVTIMPKDIQLARRIRGERA	0.71
XP_030068549.1 TYRO protein tyrosine kinase-binding protein-like isoform X1 [Microcaecilia unicolor]	MARCAHASFSIFLCVLGILGIVHGQRDCTGCYQMDGVAIAAIIVGDIIITVLIALAVFFLARKLNAKKNGAGNMENQKSGITETESHYQELQGHKLDLYCDLNQIRK	-------------------G-VHGQRDCTGCYQMDGVAIAAIIVGDIIITVL---AVFFLARKLNAKKNGAGNMENQKSGI-------------KLDLYCDLNQ--K	0.67
XP_030068550.1 TYRO protein tyrosine kinase-binding protein-like isoform X2 [Microcaecilia unicolor]	MARCAHASFSIFLCVLGILGIVHGQRDCTGCYQMDGVAIAAIIVGDIIITVLIALAVFFLARKLNAKKNGAGEEFREHAGWNYEKQMRKYGEPEIGHH	-------------------G-VHGQRDCTGCYQMDGVAIAAIIVGDIIITVL--LAVFFLARKLNAKKNGAGEEFREHAGWNYEKQMRKYGEPEIGHH	0.77
XP_030068618.1 hemoglobin subunit beta-2-like [Microcaecilia unicolor]	MVHWTDDEVKHVHDIFSKITLTEVGGDALARLLVVYPWCQRYFTSFGNLGSEDSICHNAQVKAHGLKVLSSIAEAANHLSDIKGFYTKLSKHHSEKLHVDPANFMLFARILLCTLARHCPKLFDADVQHACNKYLRVCADALGKQYH	-------------------------------LLVVYPWCQRYFTSFGNLGSEDSICHNAQVKAHGLKVLSSIAEAANHLSDIKGFYTKLSKHHSEKLHVDPANFMLFARILLCTLARHCPKLFDADVQHACNKYLRVCADALGKQYH	0.76
XP_030068630.1 bladder cancer-associated protein [Microcaecilia unicolor]	MYCLQWLLPVLLIPKPLNPALWFSHSMFMGFYLLSFLLERKPCTICALVFLAALFLVCYSCWGNCFLYHCSDSHLPESAHDPSIVGT	----------------------F-----------------KPCTICALVFLAALFLVCYSCWGNCFLYHCSDSHLPESAHDPSIVG-	0.76
XP_030068631.1 bladder cancer-associated protein [Microcaecilia unicolor]	MYCLQWLLPVLLIPKPLNPALWFSHSMFMGFYLLSFLLERKPCTICALVFLAALFLVCYSCWGNCFLYHCSDSHLPESAHDPSIVGT	----------------------F-----------------KPCTICALVFLAALFLVCYSCWGNCFLYHCSDSHLPESAHDPSIVG-	0.76
XP_030068764.1 ATP synthase subunit epsilon, mitochondrial [Microcaecilia unicolor]	MVAFWRQAGLSYIRYSQICAKAVRDALKQQYKTEAEKAAVSNIKIVKPKKDN	-----RQAGLSYIRYSQICAKAVRDALKQQYKTEAEKAAVSNIKIVKPKKDN	0.89
XP_030068914.1 fungal protease inhibitor F-like [Microcaecilia unicolor]	MKSFHLTLLLLALALQLLFLEQIRAISCPKNSHFTECDPSPCEVTCDRRSFQCNTMCQLGEFCACDPNYIRDSKGICIPPSQCPQTAK	-------------------------ISCPKNSHFTECDPSPCEVTCDRRSFQCNTMCQLGEFCACDPNYIRDSKGICIPPSQCPQTAK	0.87
XP_030068927.1 C-X-C motif chemokine 2-like [Microcaecilia unicolor]	MFIKLIFLALLAINLVASRSITMDGGRCSCYRTVSKITFHSRQVKTIEILPPSASCENVEIIVNLKNGRQLCLDPHEDKIKNIFRELINKKKI	---------------------TMDGGRCSCYRTVSKITFHSRQVKTIEILPPSASCENVEIIVNLKNGRQLCLDPHEDKIKNIFRELINKKKI	0.81
XP_030069037.1 cadherin-4-like [Microcaecilia unicolor]	MAGKGVGEMQRACKMSAGSDPVLLLLLLGLAGFLRAQHTRELTVRPTCVPGFSEEGYTALVSPDIPEGQKLLKERCLNSQDCNKRRSYVSL	---------QRACK--------------------RAQHTRELTVRPTCVPGFSE-----LVSPDIPE-QKLLKERCLNSQDCNKRRSYVS-	0.63
XP_030069119.1 keratin, type I cytoskeletal 9-like isoform X1 [Microcaecilia unicolor]	MKIAIAFLLVALSCCYQDALGLGLLGGLGGLGGLTGGLTGGLTGGLSGGAGVIGGATGGVSGGISGGAGMTGAVSGGAGAIGGATGGVSGVGGLTSGLTAGISGGSGAGASGGLLGGLLGGAGDSLDVSVLVGCVQQLLTSDATKFVNSVGGFLTSHCNYKKWGTEDSLRQACRAAKNMLNDAGCSADEVLKIVGLDITQDFLGEVGKQCDPLLSAIYDLVNKVLPQSDIVLNTICSLELDKVIDALEGLLSGGVSAVGGLASGVLDAAGGVTGGILDGALGAVGGVTGGLSVLG	----------------------------------------------------------------------------------------------------------------------------------------------------------------------------------------------------------------------------------------------------------L---VSAVGGLASGVLDAAGGVTGGILDGALGAVGGVTGGLSVL-	0.67
XP_030069208.1 interleukin-17B [Microcaecilia unicolor]	MISSQKLFLFCLFFVLTVLVPAEHPKIKHKKEKSRKKDHHGVNTHRGFKKTSPDPVLRVNAVPSAGVRDYTLVEDYEQSLQDMVNQLLNSSEPAGSKCEVNLRLWVSNKRSLSPWTYSINHDEHRIPVDIPEARCLCSGCINPFTMQEDRTMSSIPIYSKIPVKRQLCHVAKAGQKHKPRKKCRKYESVMENVAVGCTCIL	--------------------------------------------------------------------------------------------------------W-----SLSPWTYSINH-E-RIPVDIPEARCLCSGCINPFTMQEDRTMSSIPIYSKIPVKRQLCHVAKAGQKHKPRKKCRKYESVMENVAVGCTCIL	0.78
XP_030069337.1 ly6/PLAUR domain-containing protein 3-like isoform X2 [Microcaecilia unicolor]	MTGGLECYSCTEEGDAGCSADKIVKVSCAQAMNVCMDYTHTIKTDALNMTIRKKGCSSGLTKTYDSEGSFVQHCYVTHINACNTSLCNNDLTNAIRPRLCTIASDVPNGMECYACLSFSKDQCSPKYAEKIKCTGYNTNCYKENQTVSLGNDYSSRTIYIETCSQDGSCSRSYSSTNMHMKIKGKGSCCSGKFCNKAHVFFSSVSHFFLLLGMLIVTVLL	----------------GCSADKIVKVSCAQAMNVCMDYTHTIKTDALNMTIRKKGCSSGLTKTYDSEGSFVQHCYVTHINACNTSLCNNDLTNAIRPRLCTIASDVP-GME-YACLS-S-DQCS-KYAEKIKCTGYNTN-------------------------------RSY---NMH-KIK-KGSCCSGKFCNKAHVFF-------------------	0.6
XP_030069378.1 WAP four-disulfide core domain protein 5-like isoform X1 [Microcaecilia unicolor]	MKTMGSIVFLSVLLAFCTQLGSASFPSTDHPGGCPYDSGFCKQTLPAMCSGDVNCAPNAKCCYSMCKMQCVAAIFDKPGECPNIAEKCALPKTECSNDFDCKDAYKCCPICGRLCWPSN	-----------------------SFPSTDHPGGCPYDSGFCKQTLPAMCSGDVNCAPNAKCCYSMCKMQCVAAIFDKPGECPNIAEKCALPKTECSNDFDCKDAYKCCPICGRLCWPSN	0.93
XP_030069379.1 WAP four-disulfide core domain protein 12-like isoform X2 [Microcaecilia unicolor]	MKTIGSIVFLSVLLAFCTELGSASFPGINHPGGCPYDNVRCIQSYPPMCSGDVECAPNAKCCYSKCKMQCVAAIFD	-----------------------SFPGINHPGGCPYDNVRCIQSYPPMCSGDVECAPNAKCCYSKCKMQCVAAIFD	0.92
XP_030069380.1 WAP four-disulfide core domain protein 12-like isoform X1 [Microcaecilia unicolor]	MKTMGSIVFLSVLLAFCTQLGSASFPSTDHPGGCPYDNVRCIQSYPPMCSGDVECAPNAKCCYSKCKMQCVAAIFD	----------------------ASFPSTDHPGGCPYDNVRCIQSYPPMCSGDVECAPNAKCCYSKCKMQCVAAIFD	0.89
XP_030069381.1 WAP four-disulfide core domain protein 5-like isoform X2 [Microcaecilia unicolor]	MKTIGSIVFLSVLLAFCTELDSASFPSKDHPGFCPDDFMRCLLSYPPDCTYDVECATYEKCCSYMCKMQCKAAIFD	----------------------------DHPGFCPDDFMRCLLSYPPDCTYDVECATYEKCCSYMCKMQCKAAIFD	0.9
XP_030069382.1 WAP four-disulfide core domain protein 5-like isoform X3 [Microcaecilia unicolor]	MKTMGSIVFLSVLLAFCTQLGSASFPSTDHPGFCPDDFMRCLLSYPPDCTYDVECATYEKCCSYMCKMQCKAAIFD	-----------------------SFPSTDHPGFCPDDFMRCLLSYPPDCTYDVECATYEKCCSYMCKMQCKAAIFD	0.91
XP_030069383.1 WAP four-disulfide core domain protein 5-like [Microcaecilia unicolor]	MKTIGSIVFLSVLLAFCTELGSASFPSKDHPGFCPDDIIQCVVAYPPDCTYDVECATNEKCCSSMCKMQCIPAIFD	-----------------------SFPSKDHPGFCPDDIIQCVVAYPPDCTYDVECATNEKCCSSMCKMQCIPAIFD	0.9
XP_030069400.1 reactive oxygen species modulator 1 [Microcaecilia unicolor]	MPVAVGPYGQSQPSCFDRVKMGFMMGFAVGMAAGALFGTFSCLRIGMRGRELMGGVGKTMMQSGGTFGTFMAIGMGIRC	------------PSCFDRVKMGFMMGFAVGMAAGALFGTFSCLRIGMRGRELMGGVGKTMMQSGGTFGTFMAIGMGIRC	0.8
XP_030070459.1 glycoprotein hormone beta-5 [Microcaecilia unicolor]	MRLCHVMWGSLQLLLLTACLHVLKTSNVNLHTFIGCAVREFTFVAKKPGCRGLRITTDACWGRCETWEKPVLDPPYLEAHHRVCTYNETKLVTLKLPNCGPDVDPFYTYPVAIRCGCDICSTASTECETL	------------------------------HTFIGCAVREFTFVAKKPGCRGLRITTDACWGRCETWEKPVLDPPYL-----VCT-N--KLVTLKLPNCGPDVDPFYTYPVAIRCGCDICSTASTECET-	0.75
XP_030070914.1 WAP four-disulfide core domain protein 2-like [Microcaecilia unicolor]	MKTSGGAFLFVVFLTLWTALQSENPGMCPVPNEYGLGRCSTACTHDIQCSKDKKCCKTACGGTACRKPFFPNRSEKPGRCPDPDEYGELGFGICEEMCIQDTECSGDLKCCKTACGVTSCLKPQTFPNRPASNRGRCPYNWKPCRTPFFPSVSQCQGDWQCQMNQKCCSVGCDKQCVNIWAGLPIEY	-------------------------GMCPVPNEYGLGRCSTACTHDIQCSKDKKCCKTACGGTACRKPFFPNRSEKPGRCPDPDEYGELGFGICEEMCIQDTECSGDLKCCKTACGVTSCLKPQTFPNRPASNRGRCPYNWKPCRTPFFPSVSQCQGDWQCQMNQKCCSVGCDKQCVNIWAGLPIEY	0.86
XP_030071317.1 lysozyme C [Microcaecilia unicolor]	MKTLLLILGAFLTLPASDGKVFERCEFAARAKSLGLDGFRGYSLPNWVCTAFHESRFNTRATNFNRIDNSTDYGILQINSRWWCFDGKTPRSKNACGINCSELMTDDITASVICAKRVVSDPAGMGAWVAWRNYCQGRDLSEWIKGCRLDAIGF	--------------------VFERCEFAARAKSLGLDGFRGYSLPNWVCTAFHESRFNTRATNFNRIDNSTDYGILQINSRWWCFDGKTPRSKNACGINCSELMTDDITASVICAKRVVSDPAGMGAWVAWRNYCQGRDLSEWIKGCRLDAIGF	0.91
XP_030071560.1 unique cartilage matrix-associated protein [Microcaecilia unicolor]	MNRKEILLLSGLATFVLLTILQEGEGAALGSPKTDAEKTKPNPKKNIFLQDSEASNFLKRRSKRSPRSRDEVNAENRQRQAADERRREYYEEQRNEYENYAEEQHDEHQERNREHTEQWRQWHYNNMYPSYLYHRYY	----------------------------------------------------------------------------------------------------------------------WRQWHYNNMYPSYLYHRYY	0.8
XP_030071654.1 interleukin-7 isoform X3 [Microcaecilia unicolor]	MLNVFFRYIFGIPSLMLVLLPSTSPACERRNMTVILENYKNIIQREIDHLEISSLCQIECALQKQAKAIHRNFRCLVYRMSQSLSATLECRCRNAHQKREKAVETKERKKTSKQTEECKTISQPSGEKKCTRALCKLMKTISSFRSCWNKLAYLSSNRTLLENIC	-------------------------------------------------------------------AIHRNFRCL-------------CRCRN-H----------------------KTISQPSGEKKCTRALCKLMKTISSFRSCWNKLAYLSSNRTLLENIC	0.73
XP_030072343.1 resistin-like beta [Microcaecilia unicolor]	MKVIIFFLLIVLLESGFVAANPDQCTISDLETLEKFCKPKECECKLSCSSVKANGAYATCPTGKTAAACSCGMACGSWDIQNEATCHCQCSGIDWTTARCC	-------------------------TISDL-TLEKFCKPKECECKLSCSSVKANGAYATCPTGKTAAACSCGMACGSWDIQNEATCHCQCSGIDWTTARCC	0.91
XP_030072359.1 transmembrane protein 207 [Microcaecilia unicolor]	MKGTAGSVLPLTSHTGVFSFALFQVAYSDLQCENSELSLMYSAQPISVWYVWFCPLLLLVVVLCCVILLCLQWWIRKRSKCSARRTLTVVALNDSDAAYETETSHCSYAGAHRHPQNLKFAHACPAIDDGVVGASAPPSYEDIFKTTKV	------------------------------------------------------P------------LLCLQWWIRKRSKCSARRTLTVV--------------HCSYAGAHRHPQNLKFAHACPAIDDGVVGASAPPSYEDIFKTTK-	0.67
XP_030072363.1 somatostatin [Microcaecilia unicolor]	MLSCSVRCALALLSLALVVSSVSAAPTDPRLRQFLQKSLAAAAGKQELAKYFLAELLSEPSQAENEVLESDDLSRGAEQDEMRLELERSANSNPALAPRERKAGCKNFFWKTFTSC	-----------------------------------------------------------------------------------------------------KAGCKNFFWKTFTSC	0.87
XP_030072458.1 small integral membrane protein 30 [Microcaecilia unicolor]	MAGLDYTPRCLLAFLPLLGLLPTAEAMDGGNAVALLLGIIIGIFGFCVCLGYYAKKRNEQL	-----------------------------------L-GIIIGIFGFCVCLGYYAKKRNEQL	0.82
XP_030072459.1 small integral membrane protein 30 [Microcaecilia unicolor]	MAGLDYTPRCLLAFLPLLGLLPTAEAMDGGNAVALLLGIIIGIFGFCVCLGYYAKKRNEQL	-----------------------------------L-GIIIGIFGFCVCLGYYAKKRNEQL	0.82
XP_030072568.1 C-type natriuretic peptide [Microcaecilia unicolor]	MQIKHVLACGLLLAALCISLEAKPLNQQKSLRSILDKELAEYLASRDRGDKVGSLKSQSRLLRDLHIDSRSQTTWARVLNNYPNIKKRKVTNNNNKKGSTSKGCFGLKLDRIGALSNLGC	----------------------------------------EYLAS-DRGDKVGSLKSQSRLLRDLHIDSRSQTTWARVLNNYPNIKKRKVTNNNNKKGSTSKGCFGLKLDRIGALSNLGC	0.83
XP_030072570.1 unique cartilage matrix-associated protein-like [Microcaecilia unicolor]	MNRKEILLLSGLATFVLLTILQEGEGAALGSPKTDAEKTKPNPKKNIFLQDSEASNFLKRRSKRSPRSRDEVNAENRQRQAADERRREYYEEQRNEYENYAEEQHDEHQERNREHTEQWRQWHYNNMYPSYLYHRYY	----------------------------------------------------------------------------------------------------------------------WRQWHYNNMYPSYLYHRYY	0.8
XP_030072918.1 chemokine-like protein TAFA-5 isoform X1 [Microcaecilia unicolor]	MQLLKALWALAGAAICCFLVFVIHSQFLKEDLVSSVMEILDLTMFQGQLAAGTCEIVTLDRDSSQPRRTIARQTARCACKKGQIAGTTRARPACVDARIIKTKQWCEMLPCLEGEGCDLLINRSGWTCTQPGGRIKTTTGVLGGLLFQNKALLSTVLPGLLTNAATENPRRSGIGSV	--------------ICC--------------------------------------I------------TIARQTARCACKKGQIAGTTRARPACVDARIIKTKQWCEMLPCLEGEGCDLLINRSGWTCTQPGGRIKTTTGVLGGLLFQNKALLSTVLPGLLTNAATENPRRSGIGSV	0.7
XP_030072919.1 chemokine-like protein TAFA-5 isoform X2 [Microcaecilia unicolor]	MQLLKALWALAGAAICCFLVFVIHSQFLKEDLVSSVMEILDLTMFQGQLAAGTCEIVTLDRDSSQPRRTIARQTARCACKKGQIAGTTRARPACVDARIIKTKQWCEMLPCLEGEGCDLLINRSGWTCTQPGGRIKTTTVS	--------------ICC-----------------------------------TCEIVT-D--------TIARQTARCACKKGQIAGTTRARPACVDARIIKTKQWCEMLPCLEGEGCDLLINRSGWTCTQPGGRIKTTTVS	0.85
XP_030073019.1 resistin-like [Microcaecilia unicolor]	MKVVGGFLLIVLLKFGFVATSPDQCTISDILSLESFCRSAVSTDLTKPQITCTTISAKGAYATCPSDHIPTSCSCGMACGSWDVQNELMCHCQCNNIDWTAARCCRINAR	------------------------------------CRS-VSTDLTKPQITCTTISAKGAYATCPSDHIPTSCSCGMACGSWDVQNELMCHCQCNNIDWTAARCCRINA-	0.86
XP_030073253.1 histone H3 [Microcaecilia unicolor]	MARTKQTARKSTGGKAPRKQLATKAARKSAPATGGVKKPHRYRPGTVALREIRRYQKSTELLIRKLPFQRLVREIAQDFKTDLRFQSSAVMALQEASEAYLVGLFEDTNLCAIHAKRVTIMPKDIQLARRIRGERA	--------RKSTGGKAPRKQLATKAARKSAPATGGVKKPHRYRPGTVALREIRRYQKSTELLIRKLPFQRLVREIAQDFKTD-RFQ------------------FEDTNLCAIHAKRVTIMPKDIQLARRIRGERA	0.69
XP_030073254.1 histone H2A type 1-E [Microcaecilia unicolor]	MSGRGKQGGKARAKAKTRSSRAGLQFPVGRVHRLLRKGNYAERVGAGAPVYLAAVLEYLTAEILELAGNAARDNKKTRIIPRHLQLAIRNDEELNKLLGRVTIAQGGVLPNIQAVLLPKKTESHKAAKGK	----GKQGGKARAKAKTRSSRAGLQFPVGRVHRLLRKGNYAERVGAGAPVY----------------G-AARDNKKTRIIPRHLQLAIRND----KLLGRVTIAQGGVLPNIQAVLLPKKTESHKAAKG-	0.67
XP_030073255.1 histone H2A type 1-E-like [Microcaecilia unicolor]	MSGRGKQGGKARAKAKTRSSRAGLQFPVGRVHRLLRKGNYAERVGAGAPVYLAAVLEYLTAEILELAGNAARDNKKTRIIPRHLQLAIRNDEELNKLLGRVTIAQGGVLPNIQAVLLPKKTESHKAAKSK	----GKQGGKARAKAKTRSSRAGLQFPVGRVHRLLRKGNYAERVGAGAPVY----------------G-AARDNKKTRIIPRHLQLAIRND----KLLGRVTIAQGGVLPNIQAVLLPKKTESHKAAKS-	0.67
XP_030073256.1 histone H2B type 2-E [Microcaecilia unicolor]	MPEPAKSAPAPKKGSKKAVSKTQKKDGKKRKRSRKESYAIYVYKVLKQVHPDTGISSKAMNIMNSFVNDIFERIAGEASRLAHYNKRSTITSREIQTAVRLLLPGELAKHAVSEGTKAVTKYTSSK	------SAPAPKKGSKKAVSKTQKKDGKKRKRSRKESYAIYVYKVLKQVHPDTGISSKAMNIMNSFVNDIFERIAGEASRLAHYNKRSTITSREIQTAVRLLLPGELAKHAVSEGTKAVTKYTSSK	0.84
XP_030073257.1 histone H2B type 2-E [Microcaecilia unicolor]	MPEPAKSAPAPKKGSKKAVSKTQKKDGKKRKRSRKESYAIYVYKVLKQVHPDTGISSKAMNIMNSFVNDIFERIAGEASRLAHYNKRSTITSREIQTAVRLLLPGELAKHAVSEGTKAVTKYTSSK	------SAPAPKKGSKKAVSKTQKKDGKKRKRSRKESYAIYVYKVLKQVHPDTGISSKAMNIMNSFVNDIFERIAGEASRLAHYNKRSTITSREIQTAVRLLLPGELAKHAVSEGTKAVTKYTSSK	0.84
XP_030073258.1 histone H4 [Microcaecilia unicolor]	MSGRGKGGKGLGKGGAKRHRKVLRDNIQGITKPAIRRLARRGGVKRISGLIYEETRGVLKVFLENVIRDAVTYTEHAKRKTVTAMDVVYALKRQGRTLYGFGG	---RGKGGKGLGKGGAKRHRKVLRDNIQGITKPAIRRLARRGGVKRISGLI----RGVL---LE-VIRDAVTYTEH-KRKTVTAMDVVYALK-QGRTLYGFGG	0.74
XP_030073260.1 histone H4 [Microcaecilia unicolor]	MSGRGKGGKGLGKGGAKRHRKVLRDNIQGITKPAIRRLARRGGVKRISGLIYEETRGVLKVFLENVIRDAVTYTEHAKRKTVTAMDVVYALKRQGRTLYGFGG	---RGKGGKGLGKGGAKRHRKVLRDNIQGITKPAIRRLARRGGVKRISGLIYEETRGVLKVFLENVIRDAVTYTEHAKRKTVTAMDVVYALK-QGRTLYGFG-	0.84
XP_030073399.1 histone H2B type 2-E-like [Microcaecilia unicolor]	MPEPAKSAPAPKKGSKKAVSKTQKKDGKKRKRTRKESYAIYVYKVLKQVHPDTGISSKAMNIMNSFVNDIFERIAGEASCLAHYNKRSTITSREIQTAVRLLLPGELAKHAVSEGTKAITKYTSSK	-------APAPKKGSKKAVSKTQKKDGKKRKRTRKESYAIYVYKVLKQVHPDTGISSKAMNIMNSFVNDIFERIAGEASCLAHYNKRSTITSREIQTAVRLLLPGELAKHAVSEGTKAITKYTSSK	0.85
XP_030073492.1 LOW QUALITY PROTEIN: histone H3-like [Microcaecilia unicolor]	MARTKQTARKSTGGKAPRKQLATKAARKSAPATGGVKKPHRYRPGTVALREIRRYQKSTELLIRKLPFQRLVREIAQDFKTDLRFQSSAVMALQEASEAYLVGLFEDTNLCAIHAKRVTIMPKDIQLARRIRGERA	--------------------------------------------------------------------------------------------------------FEDTNLCAIHAKRVTIMPKDIQLARRIRGERA	0.7
XP_030073493.1 histone H2A type 1-E-like [Microcaecilia unicolor]	MSGRGKQGGKARAKAKTRSSRAGLQFPVGRVHRLLRKGNYAERVGAGAPVYLAAVLEYLTAEILELAGNAARDNKKTRIIPRHLQLAIRNDEELNKLLGRVTIAQGGVLPNIQAVLLPKKTESHKAAKSK	----GKQGGKARAKAKTRSSRAGLQFPVGRVHRLLRKGNYAERVGAGAPVY----------------G-AARDNKKTRIIPRHLQLAIRND----KLLGRVTIAQGGVLPNIQAVLLPKKTESHKAAKS-	0.68
XP_030073494.1 histone H2A type 1-E-like [Microcaecilia unicolor]	MSGRGKQGGKARAKAKTRSSRAGLQFPVGRVHRLLRKGNYAERVGAGAPVYLAAVLEYLTAEILELAGNAARDNKKTRIIPRHLQLAIRNDEELNKLLGRVTIAQGGVLPNIQAVLLPKKTESHKTAKSK	----GKQGGKARAKAKTRSSRAGLQFPVGRVHRLLRKGNYAERVGAGAPVY------------------AARDNKKTRIIPRHLQLAIRND----KLLGRVTIAQGGVLPNIQAVLLPKKTE-HK--KS-	0.67
XP_030073496.1 histone H2B type 2-E [Microcaecilia unicolor]	MPEPAKSAPAPKKGSKKAVSKTQKKDGKKRKRSRKESYAIYVYKVLKQVHPDTGISSKAMNIMNSFVNDIFERIAGEASRLAHYNKRSTITSREIQTAVRLLLPGELAKHAVSEGTKAVTKYTSSK	------SAPAPKKGSKKAVSKTQKKDGKKRKRSRKESYAIYVYKVLKQVHPDTGISSKAMNIMNSFVNDIFERIAGEASRLAHYNKRSTITSREIQTAVRLLLPGELAKHAVSEGTKAVTKYTSSK	0.84
XP_030073497.1 histone H2B type 2-E [Microcaecilia unicolor]	MPEPAKSAPAPKKGSKKAVSKTQKKDGKKRKRSRKESYAIYVYKVLKQVHPDTGISSKAMNIMNSFVNDIFERIAGEASRLAHYNKRSTITSREIQTAVRLLLPGELAKHAVSEGTKAVTKYTSSK	------SAPAPKKGSKKAVSKTQKKDGKKRKRSRKESYAIYVYKVLKQVHPDTGISSKAMNIMNSFVNDIFERIAGEASRLAHYNKRSTITSREIQTAVRLLLPGELAKHAVSEGTKAVTKYTSSK	0.84
XP_030073498.1 histone H4 [Microcaecilia unicolor]	MSGRGKGGKGLGKGGAKRHRKVLRDNIQGITKPAIRRLARRGGVKRISGLIYEETRGVLKVFLENVIRDAVTYTEHAKRKTVTAMDVVYALKRQGRTLYGFGG	---RGKGGKGLGKGGAKRHRKVLRDNIQGITKPAIRRLARRGGVKRISGLIYEETRGVLKVFLENVIRDAVTYTEHAKRKTVTAMDVVYALK-QGRTLYGFG-	0.84
XP_030073499.1 histone H4 [Microcaecilia unicolor]	MSGRGKGGKGLGKGGAKRHRKVLRDNIQGITKPAIRRLARRGGVKRISGLIYEETRGVLKVFLENVIRDAVTYTEHAKRKTVTAMDVVYALKRQGRTLYGFGG	---RGKGGKGLGKGGAKRHRKVLRDNIQGITKPAIRRLARRGGVKRISGLIYEETRGVLKVFLENVIRDAVTYTEHAKRKTVTAMDVVYALK-QGRTLYGFG-	0.84
XP_030073662.1 histone H4 [Microcaecilia unicolor]	MSGRGKGGKGLGKGGAKRHRKVLRDNIQGITKPAIRRLARRGGVKRISGLIYEETRGVLKVFLENVIRDAVTYTEHAKRKTVTAMDVVYALKRQGRTLYGFGG	---RGKGGKGLGKGGAKRHRKVLRDNIQGITKPAIRRLARRGGVKRISGLIYEETRGVLKVFLENVIRDAVTYTEHAKRKTVTAMDVVYALK-QGRTLYGFG-	0.84
XP_030073663.1 histone H4-like [Microcaecilia unicolor]	MSGRGKGGKGLGKGGAKRHRKVLRDNIQGITKPAIRRLARRGGVKRISGLIYEETRGVLKVFLENVIRDAVTYTEHAKRKTVTAMDVVYALKCQGRTLYGFGG	---RGKGGKGLGKGGAKRHRKVLRDNIQGITKPAIRRLARRGGVKRISGLIYEETRGVLKVFLENVIRDAVTYTEHAKRKTVTAMDVVYALKCQGRTLYGFG-	0.85
XP_030073839.1 histone H2A type 1-E [Microcaecilia unicolor]	MSGRGKQGGKARAKAKTRSSRAGLQFPVGRVHRLLRKGNYAERVGAGAPVYLAAVLEYLTAEILELAGNAARDNKKTRIIPRHLQLAIRNDEELNKLLGRVTIAQGGVLPNIQAVLLPKKTESHKAAKGK	----GKQGGKARAKAKTRSSRAGLQFPVGRVHRLLRKGNYAERVGAGAPVY----------------G-AARDNKKTRIIPRHLQLAIRND----KLLGRVTIAQGGVLPNIQAVLLPKKTESHKAAKG-	0.68
XP_030073840.1 histone H2A type 1-E [Microcaecilia unicolor]	MSGRGKQGGKARAKAKTRSSRAGLQFPVGRVHRLLRKGNYAERVGAGAPVYLAAVLEYLTAEILELAGNAARDNKKTRIIPRHLQLAIRNDEELNKLLGRVTIAQGGVLPNIQAVLLPKKTESHKAAKGK	----GKQGGKARAKAKTRSSRAGLQFPVGRVHRLLRKGNYAERVGAGAPVY----------------G-AARDNKKTRIIPRHLQLAIRND----KLLGRVTIAQGGVLPNIQAVLLPKKTESHKAAKG-	0.67
XP_030073841.1 histone H2B type 2-E [Microcaecilia unicolor]	MPEPAKSAPAPKKGSKKAVSKTQKKDGKKRKRSRKESYAIYVYKVLKQVHPDTGISSKAMNIMNSFVNDIFERIAGEASRLAHYNKRSTITSREIQTAVRLLLPGELAKHAVSEGTKAVTKYTSSK	------SAPAPKKGSKKAVSKTQKKDGKKRKRSRKESYAIYVYKVLKQVHPDTGISSKAMNIMNSFVNDIFERIAGEASRLAHYNKRSTITSREIQTAVRLLLPGELAKHAVSEGTKAVTKYTSSK	0.84
XP_030073842.1 histone H2B type 2-E-like [Microcaecilia unicolor]	MPEPAKSAPAPKKGSKKAVSKTQKKDGKKRKRSRKESYAIYVYKVLKQVHPDTGISSKAMNIMNSFVNDIFERIAGEASRLAHYNKRSTITSREIQTAVRLLLPGELAKHVVSEGTKAVTKYTSSK	------SAPAPKKGSKKAVSKTQKKDGKKRKRSRKESYAIYVYKVLKQVHPDTGISSKAMNIMNSFVNDIFERIAGEASRLAHYNKRSTITSREIQTAVRLLLPGELAKHVVSEGTKAVTKYTSSK	0.85
XP_030073843.1 histone H2B type 2-E [Microcaecilia unicolor]	MPEPAKSAPAPKKGSKKAVSKTQKKDGKKRKRSRKESYAIYVYKVLKQVHPDTGISSKAMNIMNSFVNDIFERIAGEASRLAHYNKRSTITSREIQTAVRLLLPGELAKHAVSEGTKAVTKYTSSK	------SAPAPKKGSKKAVSKTQKKDGKKRKRSRKESYAIYVYKVLKQVHPDTGISSKAMNIMNSFVNDIFERIAGEASRLAHYNKRSTITSREIQTAVRLLLPGELAKHAVSEGTKAVTKYTSSK	0.84
XP_030073844.1 histone H2B type 2-E [Microcaecilia unicolor]	MPEPAKSAPAPKKGSKKAVSKTQKKDGKKRKRSRKESYAIYVYKVLKQVHPDTGISSKAMNIMNSFVNDIFERIAGEASRLAHYNKRSTITSREIQTAVRLLLPGELAKHAVSEGTKAVTKYTSSK	------SAPAPKKGSKKAVSKTQKKDGKKRKRSRKESYAIYVYKVLKQVHPDTGISSKAMNIMNSFVNDIFERIAGEASRLAHYNKRSTITSREIQTAVRLLLPGELAKHAVSEGTKAVTKYTSSK	0.84
XP_030073911.1 ubiquitin-60S ribosomal protein L40 [Microcaecilia unicolor]	MQIFVKTLTGKTITLEVEPIDTIENVKAKIQDKEGIPPDQQRLIFAGKQLEDGRTLCDYNIQKESTLHLVLRLRGGIIEPSLRQLAQKYNCDKMICRKCYARLHPRAVNCRKKKCGHTNNLRPKKKVK	---------------------------------------------------------------------------GII-PSLRQLAQKYNCDKMICRKCYARLHPRAVNCRKKKCGHTNNLRPKKKV-	0.9
XP_030074214.1 histone H2B type 2-E [Microcaecilia unicolor]	MPEPAKSAPAPKKGSKKAVSKTQKKDGKKRKRSRKESYAIYVYKVLKQVHPDTGISSKAMNIMNSFVNDIFERIAGEASRLAHYNKRSTITSREIQTAVRLLLPGELAKHAVSEGTKAVTKYTSSK	------SAPAPKKGSKKAVSKTQKKDGKKRKRSRKESYAIYVYKVLKQVHPDTGISSKAMNIMNSFVNDIFERIAGEASRLAHYNKRSTITSREIQTAVRLLLPGELAKHAVSEGTKAVTKYTSSK	0.84
XP_030074273.1 histone H2B type 2-E [Microcaecilia unicolor]	MPEPAKSAPAPKKGSKKAVSKTQKKDGKKRKRSRKESYAIYVYKVLKQVHPDTGISSKAMNIMNSFVNDIFERIAGEASRLAHYNKRSTITSREIQTAVRLLLPGELAKHAVSEGTKAVTKYTSSK	------SAPAPKKGSKKAVSKTQKKDGKKRKRSRKESYAIYVYKVLKQVHPDTGISSKAMNIMNSFVNDIFERIAGEASRLAHYNKRSTITSREIQTAVRLLLPGELAKHAVSEGTKAVTKYTSSK	0.84
XP_030074282.1 histone H2B type 2-E [Microcaecilia unicolor]	MPEPAKSAPAPKKGSKKAVSKTQKKDGKKRKRSRKESYAIYVYKVLKQVHPDTGISSKAMNIMNSFVNDIFERIAGEASRLAHYNKRSTITSREIQTAVRLLLPGELAKHAVSEGTKAVTKYTSSK	------SAPAPKKGSKKAVSKTQKKDGKKRKRSRKESYAIYVYKVLKQVHPDTGISSKAMNIMNSFVNDIFERIAGEASRLAHYNKRSTITSREIQTAVRLLLPGELAKHAVSEGTKAVTKYTSSK	0.84
XP_030074471.1 histone H2B type 2-E [Microcaecilia unicolor]	MPEPAKSAPAPKKGSKKAVSKTQKKDGKKRKRSRKESYAIYVYKVLKQVHPDTGISSKAMNIMNSFVNDIFERIAGEASRLAHYNKRSTITSREIQTAVRLLLPGELAKHAVSEGTKAVTKYTSSK	------SAPAPKKGSKKAVSKTQKKDGKKRKRSRKESYAIYVYKVLKQVHPDTGISSKAMNIMNSFVNDIFERIAGEASRLAHYNKRSTITSREIQTAVRLLLPGELAKHAVSEGTKAVTKYTSSK	0.84
XP_030074692.1 scavenger receptor class F member 2 [Microcaecilia unicolor]	MEMKQDPGKRSFPWEIGGSSLWFLLLLLCLSFGQGQELSPRGRNVCRSPGSSAGFECCPGWKQQGDDCLIPVCDGNFTCKENEVCVRPNECRCRHGYFGANCDTKCPRQFWGPDCKEMCKCYPNGQCDDVTGQCTCNPNRWGSKCENACLCKHGKCNKDTGKCTCEPSWWGPQCANACYCSSTSQCNQQTGRCLCQSGWWGRSCNTQCTCNNSPCDQFTGRCQCKERHWGPRCESYCQCFRGKCNQLDGTCTCEPGYRGKLCREPCPAGLYGQGCRKRCGQCKEQQPCTVAEGRCIACEAGWNGTKCDKVCSTGFYGEGCEKVCPPCKDGHNCNHIDGKCSHCNPGWMGDRCELKCHNGTYGENCAFVCSSCFSGDCHFETGKCLCSAGSYGLHCNATCPAGQFGVNCEQFCDCHDDRCDPVTGACRMEVNQRMGVIGAGVLVTMLLILLFCLFCCCCICRKKEGMMDTDQEQATATKAQRRLCGCFSRITMKLPCIPLHRQKLPKVVVAHHDVENTLNCSFIEPPSVVELPSPSWSSRGSFSSFDTTDEGPVYCVPHEDSVSESKEKVNSSPVEKVALPIREDEAGEYTFLKEMEASKAFQVDSSEMPLLKSSDSERSSCGSGSTGGALYAKIARLSKQSKDEDENTMDFKSATIGGKPPSPERTKPPPPDPSTKPKISWIHGKYNPNQTNSLPVMSRSSDKAVSQSVSTENSQVHVKEQNRKRTPSSTSASPPTKSEDRVVLRNKDKAHKHQKDMNLSETTEPEELQPPSRAKPRTKTSQDQMEHINGAVQNVLKKIGNFHVDKKGGEAREAPKSPNHSKSRSEVIHPHFSSEAATLLAAQLKEKTQSLNRNEDGTKQNGVGPLQAQKEKPTPPQKAKRSVANANQKSSKAVLPTTISLQKMISPVSEAIPSEDKNVEKQNSNGSQEQAPSAKQNMSDPAVKKTPIKKPPRKKSREATLDCDTKNEVKTAIMPPQTVK	-------------------------------------------N-CRS----AGFEC------------------------------PNECRCRHGYFGANCDTKCPRQFWGPDCKEMCKCYPNGQ--DVTGQCTCNPNRWGSKCENACLCKHGKCNKDTGKCTCEPSWWGPQCANACYCSSTSQCNQQTGRCLCQSGWWGRSCNTQCTCNNSPCDQFTGRCQCKERHWGPRCESYCQCFRGKCNQLDGTCTCEPGYRGKLCREPCPAGLYGQGCRKRCGQCKEQQPCTVAEGRCIAC----------------------------------------------------------------------------------------------------------------------------------------------------------------------------------------------------------------------------------------------------------------------------------------------------------------------------------------------------------------------------------------------------------------------------------------------------------------------------------------------------------------------------------------------------------------------------------------------------------------------------------------------------------------------------------------------------------	0.63
XP_030074751.1 histone H2A type 1-E-like [Microcaecilia unicolor]	MSGRGKQGGKARAKAKTRSSRAGLQFPVGRVHRLLRKGNYAERVGAGAPVYLAAVLEYLTAEILELAGNAARDNKKTRIIPRHLQLAIRNDEELNKLLGRVTIAQGGVLPNIQAVLLPKKTESHKAAKSK	-------GGKARAKAKTRSSRAGLQFPVGRVHRLLRKGNYAERVG--A---------------------AARDNKKTRIIPRHLQLAIRND----KLLGRVTIAQGGVLPNIQAVLLPKKTESHKAAKS-	0.65
XP_030074752.1 histone H2A type 1-E [Microcaecilia unicolor]	MSGRGKQGGKARAKAKTRSSRAGLQFPVGRVHRLLRKGNYAERVGAGAPVYLAAVLEYLTAEILELAGNAARDNKKTRIIPRHLQLAIRNDEELNKLLGRVTIAQGGVLPNIQAVLLPKKTESHKAAKGK	----GKQGGKARAKAKTRSSRAGLQFPVGRVHRLLRKGNYAERVGAGAPVY----------------G-AARDNKKTRIIPRHLQLAIRND----KLLGRVTIAQGGVLPNIQAVLLPKKTESHKAAKG-	0.69
XP_030074813.1 histone H2A type 1-E-like [Microcaecilia unicolor]	MSGRGKQGGKARAKAKTRSSRAGLQFPVGRVHRLLRKGNYAERVGAGAPVYLAAVLEYLTAEILELAGNAARDNKKTRIIPRHLQLAIRNDEELNKLLGRVTIAQGGVLPNIQAVLLPKKTESHKAAKSK	----GKQGGKARAKAKTRSSRAGLQFPVGRVHRLLRKGNYAERVGAGAPVY----------------G-AARDNKKTRIIPRHLQLAIRND----KLLGRVTIAQGGVLPNIQAVLLPKKTESHKAAKS-	0.68
XP_030074941.1 peptidoglycan recognition protein 1-like [Microcaecilia unicolor]	MTRLVMLLLLLSALWAIAQGCPPIISRAKWGARSTRCNQSLGRNLPYVFIHHTAGSSCNSLSTCCAQLKGIQNYHIGKKWCDIAYNFLISADGSVYEGRGWSSVGTHTSGYNSKSIAISFIGDFMKYAPTNAALYAAKSLISCAVSRGFVSSAHTLKGHRNVNPTSCPGDLLYNAIKTWPSFRA	-----------------AQGCPPIISRAKWGARSTRCNQSLGRNLPYVFIHHTAGSSCNSLSTCCAQLKGIQNYHIGKKWCDIAYNFLISADGSVYEGRGWSSVGTHTSGYNSKSIAISFIGDFMKYAPTNAALYAAKSLISCAVSRGFVSSAHTLKGHRNVNPTSCPGDLLYNAIKTWPSFRA	0.93
XP_030074952.1 histone H2A type 1-E-like [Microcaecilia unicolor]	MSGRGKQGGKARAKAKTRSSRAGLQFPVGRVHRLLRKGNYAERVGAGAPVHLAAVLEYLTAEILELAGNAARDNKKTRIIPRHLQLAIRNDEELNKLLGRVTIAQGGVLPNIQAVLLPKKTESHKAAKGK	----GKQGGKARAKAKTRSSRAGLQFPVGRVHRLLRKGNYAERVGAGAPVH----------------G-AARDNKKTRIIPRHLQLAIRND----KLLGRVTIAQGGVLPNIQAVLLPKKTESHKAAKG-	0.69
XP_030074964.1 non-histone chromosomal protein HMG-17 [Microcaecilia unicolor]	MPKRKAEGDAKADKAKTKDEPQRRSARLSAKPAPPKPEPKPKKAAPKKADKLPKGKKGKADSGKEGNNPSENGEAKSDQAQKAEDAGDAK	-------GDAKADKAKTKDEPQRRSARLSAKPAPPKPEPKPKKAAPKKADKLPKGKKGKADSGKEGNNPSE-------------------	0.78
XP_030075331.1 histone H2A type 1-E-like [Microcaecilia unicolor]	MSGRGKQGGKARAKAKTRSSRAGLQFPVGRVHRLLRKGNYAERVGAGAPVYLAAVLEYLTAEILELAGNAARDNKKTRIIPRHLQLAIRNDEELNKLLGRVTIAQGGVLPNIQAVLLPKKTESHKAAKSK	----GKQGGKARAKAKTRSSRAGLQFPVGRVHRLLRKGNYAERVGAGAPVY----------------G-AARDNKKTRIIPRHLQLAIRND----KLLGRVTIAQGGVLPNIQAVLLPKKTESHKAAKS-	0.67
XP_030075332.1 histone H2A type 1-E-like [Microcaecilia unicolor]	MSGRGKQGGKARAKAKTRSSRAGLQFPVGRVHRLLRKGNYAERVGAGAPVYLAAVLEYLTAEILELAGNAARDNKKTRIIPRHLQLAIRNDEELNKLLGRVTIAQGGVLPNIQAVLLPKKTESHKAAKSK	----GKQGGKARAKAKTRSSRAGLQFPVGRVHRLLRKGNYAERVGAGAPVY----------------G-AARDNKKTRIIPRHLQLAIRND----KLLGRVTIAQGGVLPNIQAVLLPKKTESHKAAKS-	0.68
XP_030075333.1 histone H2B type 2-E [Microcaecilia unicolor]	MPEPAKSAPAPKKGSKKAVSKTQKKDGKKRKRSRKESYAIYVYKVLKQVHPDTGISSKAMNIMNSFVNDIFERIAGEASRLAHYNKRSTITSREIQTAVRLLLPGELAKHAVSEGTKAVTKYTSSK	------SAPAPKKGSKKAVSKTQKKDGKKRKRSRKESYAIYVYKVLKQVHPDTGISSKAMNIMNSFVNDIFERIAGEASRLAHYNKRSTITSREIQTAVRLLLPGELAKHAVSEGTKAVTKYTSSK	0.84
XP_030075335.1 histone H2B type 2-E [Microcaecilia unicolor]	MPEPAKSAPAPKKGSKKAVSKTQKKDGKKRKRSRKESYAIYVYKVLKQVHPDTGISSKAMNIMNSFVNDIFERIAGEASRLAHYNKRSTITSREIQTAVRLLLPGELAKHAVSEGTKAVTKYTSSK	------SAPAPKKGSKKAVSKTQKKDGKKRKRSRKESYAIYVYKVLKQVHPDTGISSKAMNIMNSFVNDIFERIAGEASRLAHYNKRSTITSREIQTAVRLLLPGELAKHAVSEGTKAVTKYTSSK	0.84
XP_030075336.1 histone H4 [Microcaecilia unicolor]	MSGRGKGGKGLGKGGAKRHRKVLRDNIQGITKPAIRRLARRGGVKRISGLIYEETRGVLKVFLENVIRDAVTYTEHAKRKTVTAMDVVYALKRQGRTLYGFGG	---RGKGGKGLGKGGAKRHRKVLRDNIQGITKPAIRRLARRGGVKRISGLIYEETRGVLKVFLENVIRDAVTYTEHAKRKTVTAMDVVYALK-QGRTLYGFG-	0.84
XP_030075337.1 histone H4 [Microcaecilia unicolor]	MSGRGKGGKGLGKGGAKRHRKVLRDNIQGITKPAIRRLARRGGVKRISGLIYEETRGVLKVFLENVIRDAVTYTEHAKRKTVTAMDVVYALKRQGRTLYGFGG	---RGKGGKGLGKGGAKRHRKVLRDNIQGITKPAIRRLARRGGVKRISGLIYEETRGVLKVFLENVIRDAVTYTEHAKRKTVTAMDVVYALK-QGRTLYGFG-	0.84
XP_030075446.1 histone H2A type 1-E-like [Microcaecilia unicolor]	MSGRGKQGGKARAKAKTRSSRAGLQFPVGRVHRLLRKGNYAERVGAGAPVYLAAVLEYLTAEILELAGNAARDNKKTRIIPRHLQLAIRNDEELNKLLGRVTIAQGGVLPNIQAVLLPKKTESHKAAKSK	--------GKARAKAKTRSSRAGLQFPVGRVHRLLRKGNYA----------------------------AA-D--KTRIIPRHLQLAIR-D----KLLGRVTIAQGGVLPNIQAVLLPKKTESHKAAKS-	0.62
XP_030075467.1 histone H4 [Microcaecilia unicolor]	MSGRGKGGKGLGKGGAKRHRKVLRDNIQGITKPAIRRLARRGGVKRISGLIYEETRGVLKVFLENVIRDAVTYTEHAKRKTVTAMDVVYALKRQGRTLYGFGG	---RGKGGKGLGKGGAKRHRKVLRDNIQGITKPAIRRLARRGGVKRISGLIYEETRGVLKVFLENVIRDAVTYTEHAKRKTVTAMDVVYALK-QGRTLYGFG-	0.84
XP_030075528.1 peptidoglycan recognition protein 1 [Microcaecilia unicolor]	MLHLIVVLSALCAVTLGCPSIVSRAAWGARPPRCNSPVMQSQRPMAIIHHTVTPSCYSLASCKRQLLGMQNYHMNSQKWCDIGYNFLIGEDGQVYEGRGWYRVGVHAGNVNPSSIGIAFIGNFSNRLPNSKAINAAKNLIQCAVSRNRLRSNYALRGHRNVMNTACPGNTLYRNILAWKNFRA	----------------GCPSIVSRAAWGARPPRCNSPVMQSQRPMAIIHHTVTPSCYSLASCKRQLLGMQNYHMNSQKWCDIGYNFLIGEDGQVYEGRGWYRVGVHAGNVNPSSIGIAFIGNFSNRLPNSKAINAAKNLIQCAVSRNRLRSNYALRGHRNVMNTACPGNTLYRNILAWKNFRA	0.91
XP_030075544.1 histone H2A type 1-E-like [Microcaecilia unicolor]	MSGRGKQGGKARAKPKTRSSRAGLQFPVGRVHRLLRKGNYAERVGAGAPVYLAAVLEYLTAEILELAGNAARDNKKTRIIPRHLQLAIRNDEELNKLLGRVTIAQGGVLPNIQAVLLPKKTESHKVAKSK	----GKQGGKARAKPKTRSSRAGLQFPVGRVHRLLRKGNYAERVGAGAPVY----------------G-AARDNKKTRIIPRHLQLAIRND----KLLGRVTIAQGGVLPNIQAVLLPKKTESHKVAKS-	0.68
XP_030075570.1 cytochrome c oxidase subunit 7A1, mitochondrial [Microcaecilia unicolor]	MSSLLVLCSGLVRGFSTSNRNWIKNRVLEKQKLFQEDNGLPVHLKGGATDALLYRITMAISLAGTCLSVFQLVRASFPRKGK	--------------FSTSNRNWIKNRVLEKQKLFQEDNGLPVH----ATDALLYRITMAISLAGTCLSVFQLVRASFPRKG-	0.71
XP_030075591.1 lymphocyte antigen 6E-like [Microcaecilia unicolor]	MMSFLTCLLAAALSVQTAHSLVCFQCEAQTSNWNCLKPVTCPNSDDQCMTAVQFGGIGSTTAYISKGCSPICIATNLNLGVIGSATNCCNSFLCNISSATSVKVSYMAMAVSAAFLCILLRARL	---------------------VCFQCEAQTSNWNCLKPVTCPNSDDQCMTAVQFGGIGSTTAYISKGCSPICIATNLNLGVIGSATNCCNSFLCNISSATSVKVS-MAM-V-AAFLCILLRARL	0.75
XP_030075599.1 lymphocyte antigen 6E-like [Microcaecilia unicolor]	MKLFLLCLLAAALSVKTVHSLTCFTCDNQSSNWKCLQPTKCDDSASYCMTTTTSGGIGSYTSFSMSKSCARICVPTNIDVGVAGTSVNCCQSDLCNYSSATNVKKSYLTLSVSAIFLVLLLWTGL	---------------------TCFTCDNQSSNWKCLQPTKCDDSASYCMTTTTSGGIGSYTSFSMSKSCARICVPTNIDVGVAGTSVNCCQSDLCNYSSATNVK-----------------WT--	0.77
XP_030075634.1 lymphocyte antigen 6E-like [Microcaecilia unicolor]	MRLFLLFLLGSALCLHTADCLKCYTCIGAQKNSDCLQETTCSPESTHCMTNVASGAGQTVITKQCVPGCKPNQFEHIGLKASVSCCQTDLCNYSGASLRISYLTLFISVGFVGSLLRAGL	----------------TADCLKCYTCIGAQKNSDCLQETTCS----HCMTN-A-GAGQTVITKQCVPGCKPNQFEHIGLKASVSCCQTDLCNYSGASLRISYLTLFISVGFVGSLLRAGL	0.71
XP_030075657.1 zinc finger matrin-type protein 5 isoform X1 [Microcaecilia unicolor]	MRTLPVSSPQQAFEGPKEVGANVLRGEMGKRYFCDYCDRSFQDNLHNRKKHLNGVQHQRCKKVWYDMFRDAFTVLLEEKTKKPCRKFLQTGQCDFGSNCRFSHMTEQDIERLTAQVEEERRAKEQQEEKGSKISDSQIKAWLERRAKRKRSARSNRNLPVEAPVFQFPPGWPSVHDLPPSLHPPPPSGGTVPPNLQWG	----------------------------------------------------------------------------------PCRKFLQTGQCDFGSNCRF-----------------------------SKISDSQIKAWLERRAKRKRSARSNRNLPVEAPVFQFPPGWPSVHDLPPSLHPPPPSGGTVPPNLQW-	0.64
XP_030075718.1 histone H2B type 1-L [Microcaecilia unicolor]	MPELAKSAPAPKKGSKKAVSKTQKKDGKKRKRSRKESYAIYVYKVLKQVHPDTGISSKAMNIMNSFVNDIFERIAGEASRLAHYNKRSTITSREIQTAVRLLLPGELAKHAVSEGTKAVTKYTSSK	------SAPAPKKGSKKAVSKTQKKDGKKRKRSRKESYAIYVYKVLKQVHPDTGISSKAMNIMNSFVNDIFERIAGEASRLAHYNKRSTITSREIQTAVRLLLPGELAKHAVSEGTKAVTKYTSSK	0.85
XP_030075731.1 histone H4-like [Microcaecilia unicolor]	MSGRGKGGKGLGKGGAKRHRKVLRDNIQGITKPAIRRLARRGGVKRISGLIYEETRRVLKVFLENVIRDAVTYTEHAKRKTVTAMDVVYALKRQGRTLYGFGG	---RGKGGKGLGKGGAKRHRKVLRDNIQGITKPAIRRLARRGGVKRISGLIYEETRRVLKVFLENVIRDAVTYTEHAKRKTVTAMDVVYALK-QGRTLYGFG-	0.83
XP_030075799.1 C-C motif chemokine 25 [Microcaecilia unicolor]	MNLRILFSLVLVCIYFYSSNAYGNFENCCLSYAKGVRVHSLLKRVNFYRMQEVNDNCNKRAIQFYLPKRNRVICGDPQESWVKSLKHKIDRMRYQSPKNKI	--------------------AYGNFENCCLSYAKGVRVHSLLKRVNFYRMQEVNDNCNKRAIQFYLPKRNRVICGDPQESWVKSLKHKIDRMRYQSPKNKI	0.9
XP_030075801.1 histone H3-like [Microcaecilia unicolor]	MARTKQTARKSTGGKAPRKQLATKAARKSAPATGGVKKPHRYRPGTVALREIRRYQKSTELLIRKLPFQRLVREIAQDFKTDLRFQSSAVMALQEASEAYLVGLFEDTNLCAIHAKRVTIMPKDIQLAIRGERA	-------ARKSTGGKAPRKQLATKAARKSAPATGGVKKPHRYRPGTVALREIRRYQKSTELLIRKLPFQRLVREIAQDFKTD-RFQ------------------FEDTNLCAIHAKRVTIMPKDIQLAIR----	0.68
XP_030075809.1 histone H4 [Microcaecilia unicolor]	MSGRGKGGKGLGKGGAKRHRKVLRDNIQGITKPAIRRLARRGGVKRISGLIYEETRGVLKVFLENVIRDAVTYTEHAKRKTVTAMDVVYALKRQGRTLYGFGG	---RGKGGKGLGKGGAKRHRKVLRDNIQGITKPAIRRLARRGGVKRISGLIYEETRGVLKVFLENVIRDAVTYTEHAKRKTVTAMDVVYALK-QGRTLYGFG-	0.84
XP_030075810.1 histone H3 [Microcaecilia unicolor]	MARTKQTARKSTGGKAPRKQLATKAARKSAPATGGVKKPHRYRPGTVALREIRRYQKSTELLIRKLPFQRLVREIAQDFKTDLRFQSSAVMALQEASEAYLVGLFEDTNLCAIHAKRVTIMPKDIQLARRIRGERA	-------ARKSTGGKAPRKQLATKAARKSAPATGGVKKPHRYRPGTVALREIRRYQKSTELLIRKLPFQRLVREIAQDFKTD-RFQ------------------FEDTNLCAIHAKRVTIMPKDIQLARRIRGERA	0.69
XP_030075813.1 histone H4-like [Microcaecilia unicolor]	MSGRGKGGNVLGRGGAKRHRKVLRDNIQGITKPTIRRLARLGGVKRISGLIYEETRGVLKVFLENVIRDAVTYTEHAKRKTVTAMDVVYALKRQGRTLYGFGG	-----KGGNVLGRGGAKRHRKVLRDNIQGITKPTIRRLARLGGVKRISGLIYEETRGVLKVFLENVIRDAVTYTEHAKRKTVTAMDVVYALK-QGRTLYGFG-	0.81
XP_030075817.1 histone H2B type 2-E [Microcaecilia unicolor]	MPEPAKSAPAPKKGSKKAVSKTQKKDGKKRKRSRKESYAIYVYKVLKQVHPDTGISSKAMNIMNSFVNDIFERIAGEASRLAHYNKRSTITSREIQTAVRLLLPGELAKHAVSEGTKAVTKYTSSK	------SAPAPKKGSKKAVSKTQKKDGKKRKRSRKESYAIYVYKVLKQVHPDTGISSKAMNIMNSFVNDIFERIAGEASRLAHYNKRSTITSREIQTAVRLLLPGELAKHAVSEGTKAVTKYTSSK	0.84
XP_030075818.1 histone H4 [Microcaecilia unicolor]	MSGRGKGGKGLGKGGAKRHRKVLRDNIQGITKPAIRRLARRGGVKRISGLIYEETRGVLKVFLENVIRDAVTYTEHAKRKTVTAMDVVYALKRQGRTLYGFGG	---RGKGGKGLGKGGAKRHRKVLRDNIQGITKPAIRRLARRGGVKRISGLIYEETRGVLKVFLENVIRDAVTYTEHAKRKTVTAMDVVYALK-QGRTLYGFG-	0.84
XP_030075819.1 histone H4 [Microcaecilia unicolor]	MSGRGKGGKGLGKGGAKRHRKVLRDNIQGITKPAIRRLARRGGVKRISGLIYEETRGVLKVFLENVIRDAVTYTEHAKRKTVTAMDVVYALKRQGRTLYGFGG	---RGKGGKGLGKGGAKRHRKVLRDNIQGITKPAIRRLARRGGVKRISGLIYEETRGVLKVFLENVIRDAVTYTEHAKRKTVTAMDVVYALK-QGRTLYGFGG	0.83
XP_030075880.1 cocaine- and amphetamine-regulated transcript protein-like [Microcaecilia unicolor]	MASCRLALLCLAYSLFCLQAACEGSLESRSTESTDKSQEEKELIEALQDVLKKLESKRMPSLEKKLGWLPSCDAGEQCAVRKGARIGKLCSCPRGTACNFYILKCL	----------------------------------------------------------MPSL--KLGWLPSCDAGEQCAVRKGARIGKLCSCPRGTACNFYILKCL	0.85
XP_030075912.1 glycoprotein hormone alpha-2 [Microcaecilia unicolor]	MSALNVLSLVLSLLLLVSESWNLEAIRPGCHLYSFNVTIQSNHQGTCRGAHKIHACVGYCESSAFPSKYSILLASDFKHNITSVSQCCTVSKLEKVKVMLDCSPAHQEFIEIFTAKSCQCDMCRLSRY	--------------------------RPGCHLYSFNVTIQSNHQGTCRGAHKIHACVGYCESSAFPSKYSILLASDFKHNITSVSQCCTVSKLEKVKVMLDCSPAHQEFIEIFTAKSCQCDMCRLSRY	0.87
XP_030075926.1 histone H2B type 2-E-like [Microcaecilia unicolor]	MPEPAKSAAAPKKGSKKAVSKTQKKDGKKRKRSRKESYAIYVYKVLKQVHPDTGISSKAMNIMNSFVNDIFERIAGEASRLAHYNKRSTITSREIQTAVRLLLPGELAKHAVSEGTKAVTKYTSSK	--------AAPKKGSKKAVSKTQKKDGKKRKRSRKESYAIYVYKVLKQVHPDTGISSKAMNIMNSFVNDIFERIAGEASRLAHYNKRSTITSREIQTAVRLLLPGELAKHAVSEGTKAVTKYTSSK	0.85
XP_030076048.1 histone H2A type 1-E-like [Microcaecilia unicolor]	MSGRGKQGGKARAKAKTRSSRAGLQFPVGRVHRLLRKGNYAERVGAGAPVYLAAVLEYLTAEILELAGNAARDNKKTRIIPRHLQLAIRNDEELNKLLGRVTIAQGGVLPNIQAVLLPKKTESHKAAKSK	----GKQGGKARAKAKTRSSRAGLQFPVGRVHRLLRKGNYAERVGAGAPVY----------------G-AARDNKKTRIIPRHLQLAIRND----KLLGRVTIAQGGVLPNIQAVLLPKKTESHKAAKS-	0.68
XP_030076049.1 histone H2A type 1-E-like [Microcaecilia unicolor]	MSGRGKQGGKARAKAKTRSSRAGLQFPVGRVHRLLRKGNYAERVGAGAPVYLAAVLEYLTAEILELAGNAARDNKKTRIIPRHLQLAIRNDEELNKLLGRVTIAQGGVLPNIQAVLLPKKTESHKAAKSK	----GKQGGKARAKAKTRSSRAGLQFPVGRVHRLLRKGNYAERVGAGAPVY----------------G-AARDNKKTRIIPRHLQLAIRND----KLLGRVTIAQGGVLPNIQAVLLPKKTESHKAAKS-	0.67
XP_030076050.1 histone H2B type 2-E [Microcaecilia unicolor]	MPEPAKSAPAPKKGSKKAVSKTQKKDGKKRKRSRKESYAIYVYKVLKQVHPDTGISSKAMNIMNSFVNDIFERIAGEASRLAHYNKRSTITSREIQTAVRLLLPGELAKHAVSEGTKAVTKYTSSK	------SAPAPKKGSKKAVSKTQKKDGKKRKRSRKESYAIYVYKVLKQVHPDTGISSKAMNIMNSFVNDIFERIAGEASRLAHYNKRSTITSREIQTAVRLLLPGELAKHAVSEGTKAVTKYTSSK	0.84
XP_030076051.1 histone H2B 1.1 [Microcaecilia unicolor]	MPEPAKSAPAPKKGSKKAVSKTQKKDGKKRRRSRKESYAIYVYKVLKQVHPDTGISSKAMNIMNSFVNDIFERIAGEASRLAHYNKRSTITSREIQTAVRLLLPGELAKHAVSEGTKAVTKYTSSK	------SAPAPKKGSKKAVSKTQKKDGKKRRRSRKESYAIYVYKVLKQVHPDTGISSKAMNIMNSFVNDIFERIAGEASRLAHYNKRSTITSREIQTAVRLLLPGELAKHAVSEGTKAVTKYTSSK	0.85
XP_030076052.1 histone H4 [Microcaecilia unicolor]	MSGRGKGGKGLGKGGAKRHRKVLRDNIQGITKPAIRRLARRGGVKRISGLIYEETRGVLKVFLENVIRDAVTYTEHAKRKTVTAMDVVYALKRQGRTLYGFGG	---RGKGGKGLGKGGAKRHRKVLRDNIQGITKPAIRRLARRGGVKRISGLIYEETRGVLKVFLENVIRDAVTYTEHAKRKTVTAMDVVYALK-QGRTLYGFG-	0.84
XP_030076062.1 histone H2A type 1-E-like [Microcaecilia unicolor]	MSGRGKQGGKARAKAKTRSSRAGLQFPVGRVHRLLRKGNYAERVGAGAPVYLAAVLEYLTAEILELAGNAARDNKKTRIIPRHLQLAIRNDEELNKLLGRVTIAQGGVLPNIQAVLLPKKTESHKAAKSK	----GKQGGKARAKAKTRSSRAGLQFPVGRVHRLLRKGNYAERVGAGAPVY----------------G-AARDNKKTRIIPRHLQLAIRND----KLLGRVTIAQGGVLPNIQAVLLPKKTESHKAAKS-	0.68
XP_030076063.1 histone H2A type 1-E-like [Microcaecilia unicolor]	MSGRGKQGGKARAKAKTRSSRAGLQFPVGRVHRLLRKGNYAERVGAGAPVYLAAVLEYLTAEILELAGNAARDNKKTRIIPRHLQLAIRNDEELNKLLGRVTIAQGGVLPNIQAVLLPKKTESHKAAKSK	----GKQGGKARAKAKTRSSRAGLQFPVGRVHRLLRKGNYAERVGAGAPVY----------------G-AARDNKKTRIIPRHLQLAIRND----KLLGRVTIAQGGVLPNIQAVLLPKKTESHKAAKS-	0.68
XP_030076064.1 histone H2B type 2-E-like [Microcaecilia unicolor]	MPEPAKSAPAPKKGSKKAVSKTQKKDGKKRKRTRKESYAIYVYKVLKQVHPDTGISSKAMNIMNSFVNDIFERIAGEASRLAHYNKRSTITSREIQTAVRLLLPGELAKHAVSEGTKAVTKYTSSK	------SAPAPKKGSKKAVSKTQKKDGKKRKRTRKESYAIYVYKVLKQVHPDTGISSKAMNIMNSFVNDIFERIAGEASRLAHYNKRSTITSREIQTAVRLLLPGELAKHAVSEGTKAVTKYTSSK	0.84
XP_030076067.1 histone H4 [Microcaecilia unicolor]	MSGRGKGGKGLGKGGAKRHRKVLRDNIQGITKPAIRRLARRGGVKRISGLIYEETRGVLKVFLENVIRDAVTYTEHAKRKTVTAMDVVYALKRQGRTLYGFGG	---RGKGGKGLGKGGAKRHRKVLRDNIQGITKPAIRRLARRGGVKRISGLIYEETRGVLKVFLENVIRDAVTYTEHAKRKTVTAMDVVYALK-QGRTLYGFG-	0.84
XP_030076068.1 histone H3 [Microcaecilia unicolor]	MARTKQTARKSTGGKAPRKQLATKAARKSAPATGGVKKPHRYRPGTVALREIRRYQKSTELLIRKLPFQRLVREIAQDFKTDLRFQSSAVMALQEASEAYLVGLFEDTNLCAIHAKRVTIMPKDIQLARRIRGERA	--------RKSTGGKAPRKQLATKAARKSAPATGGVKKPHRYRPGTVALREIRRYQKSTELLIRKLPFQRLVREIAQDFKTD-RFQ------------------FEDTNLCAIHAKRVTIMPKDIQLARRIRGERA	0.69
XP_030076086.1 syncollin [Microcaecilia unicolor]	MQLGQVFCLLPLLLAVALAQCPQPSEIKDAEGNKVCARMFEKSNAYYDQCCGGEYLDAQTGDDMPYMPLKWINRISSLVVATRCELTVWSKQPKAGNMRKFTAGITYRLKDVKKGLFGTWDNAISSYYCKCN	---------------------------------KVCARMFEKSNAYYDQCCGGEYLDAQTGDDMPYMPLKWINRISSLVVATRCELTVWSKQPKAGNMRKFTAGITYRLKDVKKGLFGTWDNAISSYYCKCN	0.84
XP_030076121.1 ubiquitin-like protein fubi and ribosomal protein S30 isoform X1 [Microcaecilia unicolor]	MKTMQLFVRAQSLHTLEVSTQETVAQLKARIESLEGFDVEDQVLLLGGAPLEDEATLEECGISSLATLEVAGRMLGGKVHGSLARAGKVRGQTPKVAKQEKKKKKTGRAKRRMQYNRRFVNVVPTFGKKKGPNANS	------------------------------------------------------------------------RMLGGKVHGSLARAGKVRGQTPKVAKQEKKKKKTGRAKRRMQYNRRFVNVVPTFGKKKGPNANS	0.86
XP_030076122.1 ubiquitin-like protein fubi and ribosomal protein S30 isoform X2 [Microcaecilia unicolor]	MQLFVRAQSLHTLEVSTQETVAQLKARIESLEGFDVEDQVLLLGGAPLEDEATLEECGISSLATLEVAGRMLGGKVHGSLARAGKVRGQTPKVAKQEKKKKKTGRAKRRMQYNRRFVNVVPTFGKKKGPNANS	---------------------------------------------------------------------RMLGGKVHGSLARAGKVRGQTPKVAKQEKKKKKTGRAKRRMQYNRRFVNVVPTFGKKKGPNANS	0.86
XP_030076123.1 histone H2A type 1-B/E-like [Microcaecilia unicolor]	MSGRGKQGGKARAKTKTRSSRAGLQFPVGRVHRLLRKGNYTERVGAGAPVYLAAVLEYLTAEILELAGNAARDNKKTRIIPRHLQLAIRNDEELNKLLGRVTIAQGDVLPNIQAVLLLKNTESHKAAKSK	----GKQGGKARAKTKTRSSRAGLQFPVGRVHRLLRKGNYTERVGAGAPV-------------------------KTRIIPRHLQLAI---------------------------------------KS-	0.65
XP_030076178.1 histone H3 [Microcaecilia unicolor]	MARTKQTARKSTGGKAPRKQLATKAARKSAPATGGVKKPHRYRPGTVALREIRRYQKSTELLIRKLPFQRLVREIAQDFKTDLRFQSSAVMALQEASEAYLVGLFEDTNLCAIHAKRVTIMPKDIQLARRIRGERA	----------STGGKAPRKQLATKAARKSAPATGGVKKPHRYRPGTVALREIRRYQKSTELLIRKLPFQRLVREIAQDFKTD-RFQ------------------FEDTNLCAIHAKRVTIMPKDIQLARRIRGERA	0.68
XP_030076179.1 histone H2A type 1-E-like [Microcaecilia unicolor]	MSGRGKQGGKARAKAKTRSSRAGLQFPVGRVHRLLRKGNYAERVGAGAPVYLAAVLEYLTAEILELAGNAARDNKKTRIIPRHLQLAIRNDEELNKLLGRVTIAQGGVLPNIQAVLLPKKTESHKAAKSK	----GKQGGKARAKAKTRSSRAGLQFPVGRVHRLLRKGNYAERVGAGAPVY----------------G-AARDNKKTRIIPRHLQLAIRND----KLLGRVTIAQGGVLPNIQAVLLPKKTESHKAAKS-	0.67
XP_030076180.1 histone H2A type 1-E-like [Microcaecilia unicolor]	MSGRGKQGGKARAKAKTRSSRAGLQFPVGRVHRLLRKGNYAERVGAGAPVYLAAVLEYLTAEILELAGNAARDNKKTRIIPRHLQLAIRNDEELNKLLGRVTIAQGGVLPNIQAVLLPKKTESHKASKSK	----GKQGGKARAKAKTRSSRAGLQFPVGRVHRLLRKGNYAERVGAGAPVY------------------AARDNKKTRIIPRHLQLAIRND----KLLGRVTIAQGGVLPNIQAVLLPKKTE--K-SKS-	0.67
XP_030076182.1 histone H2A type 1-E-like [Microcaecilia unicolor]	MSGRGKQGGKARAKAKTRSSRAGLQFPVGRVHRLLRKGNYAERVGAGAPVYLAAVLEYLTAEILELAGNAARDNKKTRIIPRHLQLAIRNDEELNKLLGRVTIAQGGVLPNIQAVLLPKKTESHKAAKSK	----GKQGGKARAKAKTRSSRAGLQFPVGRVHRLLRKGNYAERVGAGAPVY----------------G-AARDNKKTRIIPRHLQLAIRND----KLLGRVTIAQGGVLPNIQAVLLPKKTESHKAAKS-	0.67
XP_030076183.1 histone H2A type 1-E-like [Microcaecilia unicolor]	MSGRGKQGGKARAKAKTRSSRAGLQFPVGRVHRLLRKGNYAERVGAGAPVYLAAVLEYLTAEILELAGNAARDNKKTRIIPRHLQLAIRNDEELNKLLGRVTIAQGGVLPNIQAVLLPKKTESHKAAKSK	----GKQGGKARAKAKTRSSRAGLQFPVGRVHRL-----------------------------------------KTRIIPRHLQLAIRND----KLLGRVTIAQGGVLPNIQAVLLPKKTESHKAAKS-	0.65
XP_030076184.1 histone H2A type 1-E-like [Microcaecilia unicolor]	MSGRGKQGGKARAKAKTRSSRAGLQFPVGRVHRLLRKGNYAERVGAGAPVYLAAVLEYLTAEILELAGNAARDNKKTRIIPRHLQLAIRNDEELNKLLGRVTIAQGGVLPNIQAVLLPKKTESHKAAKSK	----GKQGGKARAKAKTRSSRAGLQFPVGRVHRLLRKGNYAERVGAGAPVY----------------G-AARDNKKTRIIPRHLQLAIRND----KLLGRVTIAQGGVLPNIQAVLLPKKTESHKAAKS-	0.67
XP_030076185.1 histone H2A type 1-E-like [Microcaecilia unicolor]	MSGRGKQGGKARAKAKTRSSRAGLQFPVGRVHRLLRKGNYAERVGAGAPVYLAAVLEYLTAEILELAGNAARDNKKTRIIPRHLQLAIRNDEELNKLLGRVTIAQGGVLPNIQAVLLPKKTESHKAAKSK	----GKQGGKARAKAKTRSSRAGLQFPVGRVHRLLRKGNYAERVGAGAPVY----------------G-AARDNKKTRIIPRHLQLAIRND----KLLGRVTIAQGGVLPNIQAVLLPKKTESHKAAKS-	0.68
XP_030076186.1 histone H2B type 2-E-like [Microcaecilia unicolor]	MPEPAKSAPAPKKGSKKAVNKTQKKDGKKRKRSRKESYAIYVYKVLKQVHPDTGISSKAMNIMNSFVNDIFERIAGEASRLAHYNKRSTITSREIQTAVRLLLPGELAKHAVSEGTKAVTKYTSSK	------SAPAPKKGSKKAVNKTQKKDGKKRKRSRKESYAIYVYKVLKQVHPDTGISSKAMNIMNSFVNDIFERIAGEASRLAHYNKRSTITSREIQTAVRLLLPGELAKHAVSEGTKAVTKYTSSK	0.85
XP_030076187.1 histone H2B type 2-E [Microcaecilia unicolor]	MPEPAKSAPAPKKGSKKAVSKTQKKDGKKRKRSRKESYAIYVYKVLKQVHPDTGISSKAMNIMNSFVNDIFERIAGEASRLAHYNKRSTITSREIQTAVRLLLPGELAKHAVSEGTKAVTKYTSSK	--------PAP-KGSKKAVSKTQKKDGKKRKRSRKESYAIYVYKVLKQVHPDTGISSKAMNIMNSFVNDIFERIAGEASRLAHYNKRSTITSREIQTAVRLLLPGELAKHAVSEGTKAVTKYTSSK	0.82
XP_030076189.1 histone H2B type 2-E [Microcaecilia unicolor]	MPEPAKSAPAPKKGSKKAVSKTQKKDGKKRKRSRKESYAIYVYKVLKQVHPDTGISSKAMNIMNSFVNDIFERIAGEASRLAHYNKRSTITSREIQTAVRLLLPGELAKHAVSEGTKAVTKYTSSK	------SAPAPKKGSKKAVSKTQKKDGKKRKRSRKESYAIYVYKVLKQVHPDTGISSKAMNIMNSFVNDIFERIAGEASRLAHYNKRSTITSREIQTAVRLLLPGELAKHAVSEGTKAVTKYTSSK	0.84
XP_030076190.1 histone H2B type 2-E [Microcaecilia unicolor]	MPEPAKSAPAPKKGSKKAVSKTQKKDGKKRKRSRKESYAIYVYKVLKQVHPDTGISSKAMNIMNSFVNDIFERIAGEASRLAHYNKRSTITSREIQTAVRLLLPGELAKHAVSEGTKAVTKYTSSK	------SAPAPKKGSKKAVSKTQKKDGKKRKRSRKESYAIYVYKVLKQVHPDTGISSKAMNIMNSFVNDIFERIAGEASRLAHYNKRSTITSREIQTAVRLLLPGELAKHAVSEGTKAVTKYTSSK	0.84
XP_030076191.1 histone H2B type 2-E [Microcaecilia unicolor]	MPEPAKSAPAPKKGSKKAVSKTQKKDGKKRKRSRKESYAIYVYKVLKQVHPDTGISSKAMNIMNSFVNDIFERIAGEASRLAHYNKRSTITSREIQTAVRLLLPGELAKHAVSEGTKAVTKYTSSK	------SAPAPKKGSKKAVSKTQKKDGKKRKRSRKESYAIYVYKVLKQVHPDTGISSKAMNIMNSFVNDIFERIAGEASRLAHYNKRSTITSREIQTAVRLLLPGELAKHAVSEGTKAVTKYTSSK	0.84
XP_030076194.1 histone H4 [Microcaecilia unicolor]	MSGRGKGGKGLGKGGAKRHRKVLRDNIQGITKPAIRRLARRGGVKRISGLIYEETRGVLKVFLENVIRDAVTYTEHAKRKTVTAMDVVYALKRQGRTLYGFGG	---RGKGGKGLGKGGAKRHRKVLRDNIQGITKPAIRRLARRGGVKRISGLIYEETRGVLKVFLENVIRDAVTYTEHAKRKTVTAMDVVYALK-QGRTLYGFG-	0.84
XP_030076195.1 histone H4 [Microcaecilia unicolor]	MSGRGKGGKGLGKGGAKRHRKVLRDNIQGITKPAIRRLARRGGVKRISGLIYEETRGVLKVFLENVIRDAVTYTEHAKRKTVTAMDVVYALKRQGRTLYGFGG	---RGKGGKGLGKGGAKRHRKVLRDNIQGITKPAIRRLARRGGVKRISGLIYEETRGVLKVFLENVIRDAVTYTEHAKRKTVTAMDVVYALK-QGRTLYGFG-	0.84
XP_030076197.1 histone H3 [Microcaecilia unicolor]	MARTKQTARKSTGGKAPRKQLATKAARKSAPATGGVKKPHRYRPGTVALREIRRYQKSTELLIRKLPFQRLVREIAQDFKTDLRFQSSAVMALQEASEAYLVGLFEDTNLCAIHAKRVTIMPKDIQLARRIRGERA	--------RKSTGGKAPRKQLATKAARKSAPATGGVKKPHRYRPGTVALREIRRYQKSTELLIRKLPFQRLVREIAQDFKT-----------------------FEDTNLCAIHAKRVTIMPKDIQLARRIRGERA	0.69
XP_030077042.1 histone H2A type 1-like [Microcaecilia unicolor]	MSGRGKQGGKARAKAKSRSSRAGLQFPVGRVHRLLRKGNYAERVGAGAPVYLAAVLEYLTAEILELAGNAARDNKKTRIIPRHLQLAIRNDEELNKLLGKVTIAQGGVLPNIQAVLLPKKTESHKSSKTK	----GKQGGKARAKAKSRSSRAGLQFPVGRVHRLLRKGNYAERVGAGAPVY------------------AARDNKKTRIIPRHLQLAIRND----KLLGKVTIAQGGVLPNIQAVLLPKKT--HK--K--	0.65
XP_030077303.1 prokineticin-1 [Microcaecilia unicolor]	MKTAIQVCVLLVLITFARCAVITGACERDVQCGVRTCCAISLWLRGLRMCTPLGQEGEECHPFSHKVPFLGKRQHHTCPCLANLICSKFLDGRYRCSVDFKNLDFS	---------------------ITGACERDVQCGVRTCCAISLWLRGLRMCT---------HPFSHKVPFLGKRQHHTCPCLANLICSKFLDGRYRCSVDFKNLDF-	0.71
XP_030077308.1 CD59 glycoprotein-like [Microcaecilia unicolor]	MKHLLLAVFLAAGLCNVSTALECHFCTHSKNDEECNKGIIPCGQNKNSCIVSINVENGLLSKGCAHLSDCALASKHMKSKCCDVDLCNAKLKVNNSSMVTQSNLFLLLGAVVALLHEMVPRT	-------------------------CT---------KGIIPCGQNKNSCIVSINVENGLLSKGCAHLSDCALASKHMKSKCCDVDLCNAKLKVNNS--------------------------	0.71
XP_030077456.1 colipase-like [Microcaecilia unicolor]	MRSAILLLLFILAVTFAAPQHTGLVIHLENGEPCLNSIQCDSKCCHRRNSLTHARCAPKAAESQECSPYHLNGVYYKCTCERGLTCEVGRSIVGSITNSNFGICVDPNDNVQ	---------------------------------CLNSIQCDSKCCHRRNSLTHARCAPKAAESQECSPYHLNGVYYKCTCERGLTCEVGRSIVGSITNSNFGICVDPNDNV-	0.87
XP_030077457.1 colipase-like [Microcaecilia unicolor]	MRSAILLLLFILAVTFAAPQDKGLLTNLENGELCLNSVQCKSKCCHRRDGLSLARCAPKAAESQECSPYNLIGVYYKCTCESGLTCEVDRSIVGSITNSDFGICVDPNDNVL	---------------------------------CLNSVQCKSKCCHRRDGLSLARCAPKAAESQECSPYNLIGVYYKCTCESGLTCEVDRSIVGSITNSDFGICVDPNDNV-	0.82
XP_030077722.1 peptide YY-like [Microcaecilia unicolor]	MAASLKPWPAVIALLFCTLVCLGMFVDAYPPQPENPGNNASPEEIAKYMSALRHYLNLVTRQRYGKRASPAEHVLSDLLYGESTDHNSRPRYDDSYMW	---------------------------------------------------------------------------------------SRPRYDDSYMW	0.62
XP_030077723.1 peptide YY-like [Microcaecilia unicolor]	MAASLKPWPAVIALLFCTLVCLGMFVDAYPPQPENPGNNASPEEIAKYMSALRHYLNLVTRQRYGKRASPAEHVLSDLLYGESTDHNSRPRYDDSYMW	---------------------------------------------------------------------------------------SRPRYDDSYMW	0.62
XP_030077724.1 peptide YY-like [Microcaecilia unicolor]	MAASLKPWPAVIALLFCTLVCLGMFVDAYPPQPENPGNNASPEEIAKYMSALRHYLNLVTRQRYGKRASPAEHVLSDLLYGESTDHNSRPRYDDSYMW	----------------------------------------------------------------------------------------RPRYDDSYMW	0.63
XP_030077725.1 peptide YY-like [Microcaecilia unicolor]	MAASLKPWPAVIALLFCTLVCLGMFVDAYPPQPENPGNNASPEEIAKYMSALRHYLNLVTRQRYGKRASPAEHVLSDLLYGESTDHNSRPRYDDSYMW	---------------------------------------------------------------------------------------SRPRYDDSYMW	0.62
XP_030077726.1 peptide YY-like [Microcaecilia unicolor]	MAASLKPWPAVIALLFCTLVCLGMFVDAYPPQPENPGNNASPEEIAKYMSALRHYLNLVTRQRYGKRASPAEHVLSDLLYGESTDHNSRPRYDDSYMW	---------------------------------------------------------------------------------------SRPRYDDSYMW	0.62
XP_030077761.1 gastrin/cholecystokinin-like peptide [Microcaecilia unicolor]	MMKKDSSDGWMDGWISTSWLVMYMTSAVWLSFLIAMLATTALSRHTGGVHKPEASSIQRESSKRVSFEPARRDLESSPSQEQILFVSRFLCYLFLELSNKDEFMHENSVHPIKGQDYGWMDFGRRSTEDRTLDV	-----------------SWLVMYMT--------------------T-GVHKP--------------------------------------------------------------QDYGWMDFG-----------	0.54
XP_030077784.1 colipase-like [Microcaecilia unicolor]	MRSAILLLLFILAVTFAAPQHTGLVIHLENGELCLNSIQCDSKCCHRRNSLTHARCAPKAAESQECSPYHLNGVYYKCTCERGLTCEVGRSIVGSITNSNFGICVDPNDNVQ	----------------------------------LNSIQCDSKCCHRRNSLTHARCAPKAAESQECSPYHLNGVYYKCTCERGLTCEVGRSIVGSITNSNFGICVDPNDNV-	0.86
XP_030077811.1 small integral membrane protein 35 [Microcaecilia unicolor]	MRRSTVRGLLQVNAGEYTGESGAVGAGYGEVYPRDMQFAAGPGAGMASALGLILGVSLAAMLICVVSYVLIKWHQGGWCRQSSNFIFNLDKFRHPKSVELELAPPFTISGNTSTSGYVQFHDCNM	--------L-----------------GYGEVYPRDMQFAAG---G-A------------AMLICVVSYVLIKWHQGGWCRQSSNFIFNLDKFRHP-------------S-NTSTSGYVQFHDCNM	0.64
XP_030077909.1 uncharacterized protein LOC115482321 isoform X2 [Microcaecilia unicolor]	MPSVVIQTERMEPAQEGAEKVAVTVNVNICPSFSGLGNCITWLCTKMKPVGKIFRGEQTTCGAVQMVLGVLCIACGGSFATASDSNYYRNSHLVRRDFAFWTGGVFLVSGVVSIINEKFPTRCWILLALLMNLDYLKTLFMSVTVLLLTTMIAELCITVYSGGYCLKSLCCKNSPEQDDKIAVESKNDSKEEPQDVMEICALTHMDTEASA	------------------------------PSFSGLGNCIT--------------------------------------------------------------------------------------------------------------------TVYSGGYCLKSLCCKNSPEQDDKIA-----------------------------	0.66
YP_009003578.1 ATP synthase F0 subunit 8 (mitochondrion) [Microcaecilia unicolor]	MPQLNPNPWFLIMLLVWMTILIIMMQKTSTYKSTSTMTPKSKQEQHNSWSWPW	---------------------------------------------HNSWSWPW	0.69
YP_009003582.1 NADH dehydrogenase subunit 4L (mitochondrion) [Microcaecilia unicolor]	MTLTNLTIYSTFMMAMAGLTLHRTHLMSALICLEGMMLAIFIGLALWCSQMDSMSLSINPMALITLSACEASTGLAILVATNRTHGSDLIKNLNLLQC	----------------------------------------F-G-ALWCSQM------------------------AILVATNRTHGSDLIKNLNLLQC	0.58
